UF,anomes,cadunico_tot_fam,cadunico_tot_pes,cadunico_tot_fam_rpc_ate_meio_sm,cadunico_tot_pes_rpc_ate_meio_sm,cadunico_tot_fam_pob,cadunico_tot_pes_pob,cadunico_tot_fam_ext_pob,cadunico_tot_pes_ext_pob,cadunico_tot_fam_pob_e_ext_pob,cadunico_tot_pes_pob_e_ext_pob
AC,201401,123043,487390,118275,477580,26243,105599,73758,312496,100001,418095
AC,201402,124308,490355,119256,480056,26335,105938,74260,313492,100595,419430
AC,201403,125836,494170,120422,483210,26297,105691,74926,315250,101223,420941
AC,201404,126651,496303,121058,484987,26130,105026,75422,316625,101552,421651
AC,201405,127497,498509,121697,486786,24536,97100,79899,333763,104435,430863
AC,201406,128910,502246,122774,489935,24674,97646,80374,334847,105048,432493
AC,201407,129755,504673,123432,492013,24703,97758,80800,336079,105503,433837
AC,201408,130871,507951,124323,494834,24823,98351,81310,337496,106133,435847
AC,201409,131563,509316,124802,495849,24929,98748,81484,337584,106413,436332
AC,201410,132503,512480,125539,498592,25026,99337,81889,338867,106915,438204
AC,201411,133204,514604,126063,500365,24972,99218,82330,340367,107302,439585
AC,201412,133893,516711,126575,502138,24946,99164,82719,341783,107665,440947
AC,201501,124081,485875,117699,473590,21696,88509,78007,326213,99703,414722
AC,201502,124803,488164,118299,475647,21770,88773,78356,327380,100126,416153
AC,201503,125182,489497,118629,476886,21799,88995,78567,328116,100366,417111
AC,201504,125664,491147,119027,478407,21795,89011,78826,329094,100621,418105
AC,201505,126291,493199,119550,480273,21702,88680,79224,330571,100926,419251
AC,201506,126785,494232,119906,481045,21741,88845,79129,329530,100870,418375
AC,201507,122185,478249,115234,464859,20470,84840,75773,316453,96243,401293
AC,201508,122939,480217,115777,466331,20671,85819,75390,313852,96061,399671
AC,201509,123358,481199,116089,467098,20874,86904,75017,311665,95891,398569
AC,201510,123726,482090,116344,467758,21067,88141,74752,309833,95819,397974
AC,201511,124219,483061,116709,468488,21040,88065,75036,310360,96076,398425
AC,201512,124890,484958,117255,470165,20923,87491,75547,312150,96470,399641
AC,201601,120992,475192,114634,463520,20102,84885,73514,307648,93616,392533
AC,201602,121432,476542,115018,464768,19861,84006,74135,309793,93996,393799
AC,201603,122205,478586,115688,466635,19675,83247,74976,312511,94651,395758
AC,201604,122872,480332,116278,468259,19431,82169,75796,315249,95227,397418
AC,201605,123618,482435,116949,470231,19407,82024,76424,317196,95831,399220
AC,201606,124286,483821,117501,471371,20098,84346,78702,326130,98800,410476
AC,201607,125045,485335,118133,472612,20101,84391,78857,325467,98958,409858
AC,201608,125615,486297,118585,473360,19412,82031,76778,315358,96190,397389
AC,201609,126264,487835,117677,471078,19324,81512,77242,316673,96566,398185
AC,201610,126994,489466,118189,472242,19269,81026,77509,317113,96778,398139
AC,201611,127393,490189,118457,472679,19338,81321,77527,316609,96865,397930
AC,201612,123098,477275,114556,460504,18404,78203,75672,310479,94076,388682
AC,201701,123447,478154,116946,466614,18932,80177,78103,320542,97035,400719
AC,201702,124146,479583,117555,467928,18689,79050,78883,322889,97572,401939
AC,201703,124740,480831,118032,468988,18629,78586,79396,324422,98025,403008
AC,201704,125597,482507,118729,470411,18541,77857,80068,326295,98609,404152
AC,201705,126445,484287,119433,471915,18519,77534,80416,326775,98935,404309
AC,201706,127231,485288,120028,472558,18579,77642,80329,324969,98908,402611
AC,201707,128369,487575,120934,474455,18662,77668,80706,325306,99368,402974
AC,201708,129319,489477,121647,475980,18770,77622,81053,326095,99823,403717
AC,201709,119479,458362,112717,446650,16326,68269,78406,318093,94732,386362
AC,201710,121373,462531,114023,449824,16426,68174,79194,320084,95620,388258
AC,201711,122692,465690,114813,452103,16482,68367,79533,320981,96015,389348
AC,201712,125106,470298,115883,454635,16480,68107,80039,321922,96519,390029
AC,201801,126613,473500,116806,457037,16489,68191,80225,321858,96714,390049
AC,201802,127837,476734,117704,459712,16462,67979,80918,324035,97380,392014
AC,201803,124328,465694,114474,449041,15290,63618,79781,320105,95071,383723
AC,201804,125749,469331,115663,452250,15278,63278,80743,322936,96021,386214
AC,201805,127222,472429,116821,454781,15225,62835,81737,325378,96962,388213
AC,201806,128484,475035,117769,456897,15186,62527,82397,326745,97583,389272
AC,201807,129412,476567,118454,458013,15515,63903,83081,328333,98596,392236
AC,201808,125088,462261,114738,444757,14536,60032,82540,326091,97076,386123
AC,201809,127025,466399,116192,448043,14645,60023,83364,327795,98009,387818
AC,201810,129333,471498,118011,452308,14567,59322,84140,328565,98707,387887
AC,201811,130622,473857,118850,453942,14614,59459,84564,328920,99178,388379
AC,201812,127235,460563,115321,440555,13706,55986,82967,322259,96673,378245
AC,201901,129071,464645,116689,444241,13791,56293,83993,325460,97784,381753
AC,201902,130455,467954,117809,447110,13753,55998,84931,328013,98684,384011
AC,201903,131428,469838,118569,448643,13749,56170,85446,328573,99195,384743
AC,201904,130603,466413,117717,445137,13284,54379,85399,327928,98683,382307
AC,201905,132086,469413,118938,447740,13307,54419,86420,329930,99727,384349
AC,201906,133700,472826,120143,450455,13292,54228,87394,332136,100686,386364
AC,201907,135118,475406,121088,452248,13337,54129,87959,333061,101296,387190
AC,201908,136876,479948,122133,455630,13382,54359,88380,334334,101762,388693
AC,201909,133529,468147,118866,444172,12575,51289,87390,330979,99965,382268
AC,201910,135460,472694,120143,447599,12634,51555,88091,332537,100725,384092
AC,201911,136889,475880,121083,449969,12640,51424,88664,333989,101304,385413
AC,201912,138241,478893,121920,452163,12632,51368,89177,335273,101809,386641
AC,202001,139303,481444,123085,455189,12656,51460,89504,336138,102160,387598
AC,202002,136505,471892,120456,446393,12020,49001,89126,334874,101146,383875
AC,202003,137731,474653,121333,448414,12034,48907,89577,336076,101611,384983
AC,202004,137987,474922,121518,448574,12046,48824,89660,336087,101706,384911
AC,202005,138170,474738,121687,448404,12069,48778,89770,335892,101839,384670
AC,202006,138220,474661,121730,448330,12066,48729,89801,335832,101867,384561
AC,202007,138326,474642,121815,448271,12059,48651,89854,335778,101913,384429
AC,202008,138508,474680,121966,448271,12082,48657,89950,335724,102032,384381
AC,202009,138878,474618,122291,448131,12096,48525,90178,335460,102274,383985
AC,202010,139615,475291,122904,448611,12123,48379,90631,335759,102754,384138
AC,202011,136389,465361,120234,439739,11562,46287,89615,332523,101177,378810
AC,202012,137009,466364,120768,440625,11597,46224,89996,333204,101593,379428
AL,201401,675192,2095327,633597,2036039,113476,388735,425965,1384926,539441,1773661
AL,201402,678526,2100114,635710,2039051,113794,388970,425696,1381629,539490,1770599
AL,201403,681496,2103375,637323,2040229,113795,388076,424771,1375786,538566,1763862
AL,201404,684168,2105897,638852,2040970,113631,386322,424320,1371235,537951,1757557
AL,201405,686532,2108206,640258,2041906,108674,363555,440807,1423286,549481,1786841
AL,201406,689103,2110894,641714,2043008,108792,363739,440652,1420082,549444,1783821
AL,201407,692456,2116073,644038,2046720,109053,364259,441331,1419522,550384,1783781
AL,201408,697311,2123684,647447,2052171,109695,365943,442568,1419090,552263,1785033
AL,201409,699716,2124389,648919,2051487,110074,366090,442607,1415758,552681,1781848
AL,201410,702464,2130718,650633,2056198,110462,367656,442794,1415302,553256,1782958
AL,201411,704947,2135013,652297,2059212,110795,368189,443276,1415535,554071,1783724
AL,201412,707517,2138949,653723,2061436,111413,369860,442863,1412792,554276,1782652
AL,201501,658266,2004493,608839,1935156,94087,320658,420106,1346139,514193,1666797
AL,201502,661894,2010799,610456,1938254,94582,321730,419338,1342852,513920,1664582
AL,201503,664666,2014835,611606,1939698,95205,322914,417881,1336938,513086,1659852
AL,201504,666829,2018459,612728,1941736,95578,323667,417132,1333377,512710,1657044
AL,201505,669708,2023041,614262,1944247,95697,323434,416736,1330225,512433,1653659
AL,201506,671467,2024074,614744,1943144,96077,324557,413049,1314583,509126,1639140
AL,201507,651321,1968789,595762,1888594,91757,312105,399615,1270801,491372,1582906
AL,201508,654629,1973020,597024,1889544,92532,313876,396390,1257436,488922,1571312
AL,201509,656669,1975438,597695,1889809,93406,316233,394184,1249174,487590,1565407
AL,201510,658761,1978153,598501,1890506,94598,320546,391715,1239344,486313,1559890
AL,201511,661239,1981283,599636,1891601,95077,321429,390833,1235184,485910,1556613
AL,201512,663918,1985376,600914,1893438,95399,321933,390344,1232106,485743,1554039
AL,201601,639849,1935520,583082,1855119,90867,310964,375793,1201372,466660,1512336
AL,201602,642541,1940159,584789,1858256,90579,309955,376922,1203370,467501,1513325
AL,201603,646828,1946725,587406,1862356,90075,307584,378911,1207390,468986,1514974
AL,201604,650998,1953371,590084,1866771,89310,304587,381115,1211508,470425,1516095
AL,201605,655295,1960601,592981,1872014,89304,303511,382732,1214502,472036,1518013
AL,201606,659764,1965932,595556,1874570,92518,320097,392467,1241943,484985,1562040
AL,201607,663044,1970117,597613,1876953,91987,317204,393604,1242224,485591,1559428
AL,201608,666704,1974226,599676,1878687,89815,301385,382636,1203302,472451,1504687
AL,201609,670068,1978897,591498,1859046,90229,301294,383147,1203065,473376,1504359
AL,201610,669888,1973254,589560,1850095,89909,298683,381273,1194884,471182,1493567
AL,201611,672576,1976588,590243,1849710,90474,299316,380421,1190354,470895,1489670
AL,201612,641604,1899833,564040,1778140,85962,285481,365782,1149368,451744,1434849
AL,201701,644669,1904390,580473,1813003,84496,288809,379809,1189804,464305,1478613
AL,201702,648733,1909814,583377,1816735,83768,285261,383080,1196726,466848,1481987
AL,201703,653043,1915821,586583,1821219,83494,283039,386401,1203553,469895,1486592
AL,201704,658590,1922631,590722,1826112,82948,279339,390522,1211143,473470,1490482
AL,201705,663111,1928728,594021,1830542,82450,275949,393075,1214867,475525,1490816
AL,201706,666230,1930274,596080,1830555,82281,274075,393189,1209480,475470,1483555
AL,201707,669988,1934632,598685,1833219,81897,271741,395376,1212366,477273,1484107
AL,201708,674638,1940617,601822,1837118,81353,268673,398243,1217475,479596,1486148
AL,201709,618115,1793425,552862,1700719,69785,231548,377821,1164581,447606,1396129
AL,201710,626659,1807153,558180,1710197,69374,229229,382395,1174081,451769,1403310
AL,201711,634371,1819263,561738,1716858,68829,226822,385481,1180611,454310,1407433
AL,201712,646449,1836221,565089,1722882,67993,223695,387153,1182408,455146,1406103
AL,201801,656528,1850576,569412,1730495,67452,221593,388494,1181687,455946,1403280
AL,201802,662447,1859415,572725,1735608,67105,219648,390218,1183129,457323,1402777
AL,201803,647644,1813854,558459,1690320,62225,203136,384621,1163764,446846,1366900
AL,201804,654960,1825547,563590,1698965,62147,201937,388668,1171044,450815,1372981
AL,201805,664957,1842465,570878,1712223,61932,199668,394864,1184084,456796,1383752
AL,201806,671745,1853035,575667,1720037,62036,199024,397838,1188448,459874,1387472
AL,201807,676070,1858562,578876,1724010,63652,205290,400908,1193338,464560,1398628
AL,201808,648218,1782767,557380,1657768,59389,190774,397558,1181495,456947,1372269
AL,201809,653809,1790038,561335,1662733,59582,190267,399654,1182157,459236,1372424
AL,201810,661378,1802208,566791,1671974,59037,186268,401137,1180525,460174,1366793
AL,201811,666736,1809802,570285,1676984,59056,185389,403083,1182171,462139,1367560
AL,201812,647960,1755787,552486,1624967,54880,172435,395318,1160380,450198,1332815
AL,201901,656450,1770732,557273,1636108,54596,172169,398251,1167357,452847,1339526
AL,201902,661960,1780160,560967,1642912,54570,171328,400843,1172071,455413,1343399
AL,201903,665330,1785154,563325,1646471,54621,171261,402277,1173172,456898,1344433
AL,201904,655570,1760092,555152,1623126,52663,164896,398045,1161406,450708,1326302
AL,201905,660727,1768292,558856,1629190,52839,164974,400591,1164804,453430,1329778
AL,201906,666206,1776978,562496,1635323,53051,165030,402910,1168218,455961,1333248
AL,201907,668999,1779401,563858,1635790,52952,164383,403603,1167079,456555,1331462
AL,201908,675305,1788023,567196,1640119,52910,163534,404935,1166656,457845,1330190
AL,201909,653080,1724374,547608,1580886,49378,152134,397986,1146592,447364,1298726
AL,201910,660102,1736881,551783,1589339,49718,152414,400037,1149923,449755,1302337
AL,201911,665227,1746877,554958,1596568,49910,152648,401946,1154171,451856,1306819
AL,201912,670096,1756165,557854,1603063,49908,152252,403742,1158123,453650,1310375
AL,202001,673508,1762477,561778,1611004,50074,152389,404558,1160076,454632,1312465
AL,202002,653547,1712034,545235,1566598,47578,144027,399677,1148584,447255,1292611
AL,202003,658619,1722219,548818,1573899,47912,144527,401124,1152012,449036,1296539
AL,202004,660284,1724124,549924,1575016,47955,144339,401891,1152707,449846,1297046
AL,202005,661934,1725975,551362,1576588,47990,144143,403040,1153958,451030,1298101
AL,202006,663612,1728871,552752,1579080,48138,144348,403767,1154934,451905,1299282
AL,202007,665186,1731588,554050,1581407,48295,144569,404411,1155905,452706,1300474
AL,202008,668232,1736972,556452,1585857,48564,144946,405741,1158163,454305,1303109
AL,202009,670789,1739868,558378,1587848,48811,145141,406732,1158319,455543,1303460
AL,202010,674907,1746265,561510,1592856,49130,145318,408603,1161044,457733,1306362
AL,202011,654420,1699033,546684,1553747,46730,138348,402607,1146684,449337,1285032
AL,202012,657130,1703837,548805,1557704,46917,138495,403992,1149323,450909,1287818
AM,201401,553150,1990552,514314,1932151,102869,380814,336479,1324415,439348,1705229
AM,201402,556685,1999048,517028,1939244,103878,384758,336504,1322136,440382,1706894
AM,201403,562323,2013101,521446,1951226,105342,390152,337035,1321147,442377,1711299
AM,201404,567666,2026156,525424,1962064,106368,393635,337845,1321386,444213,1715021
AM,201405,572309,2037587,528959,1971532,100717,369204,356442,1385026,457159,1754230
AM,201406,578575,2053002,533687,1984417,101768,372763,358264,1388809,460032,1761572
AM,201407,583445,2065500,537400,1995114,102462,375287,360325,1394189,462787,1769476
AM,201408,589745,2082759,542511,2010326,103751,380034,362825,1400486,466576,1780520
AM,201409,593826,2091785,545978,2018381,104843,383635,364227,1402312,469070,1785947
AM,201410,598942,2107617,549744,2032093,105734,387380,366145,1408969,471879,1796349
AM,201411,602668,2117876,552630,2041038,106271,389275,367752,1413854,474023,1803129
AM,201412,605512,2126316,554746,2048216,107128,392840,368200,1414885,475328,1807725
AM,201501,565491,2016477,522741,1951524,95704,359275,350241,1356722,445945,1715997
AM,201502,568409,2024265,524902,1958154,96085,360523,351235,1359705,447320,1720228
AM,201503,571630,2033873,527327,1966339,97158,364440,351187,1359011,448345,1723451
AM,201504,574514,2042536,529577,1973877,97893,367228,351840,1360721,449733,1727949
AM,201505,577160,2050231,531427,1980274,98258,368840,352117,1361017,450375,1729857
AM,201506,579444,2056239,532512,1983956,99104,373282,348651,1346124,447755,1719406
AM,201507,561876,2006600,516764,1935160,96148,367394,334465,1292673,430613,1660067
AM,201508,565664,2017589,518891,1943031,97455,373275,332366,1283870,429821,1657145
AM,201509,568484,2025300,520509,1948605,98487,377364,331245,1279202,429732,1656566
AM,201510,571414,2033107,522221,1954278,99589,381658,330684,1276384,430273,1658042
AM,201511,574220,2039975,523965,1959415,100255,383931,331371,1278170,431626,1662101
AM,201512,577613,2049073,526142,1966485,100816,385886,332599,1282534,433415,1668420
AM,201601,554409,1989762,511131,1923431,96378,372824,320637,1249767,417015,1622591
AM,201602,557340,1997025,513222,1929465,96198,371620,323082,1257987,419280,1629607
AM,201603,561862,2008654,516765,1939666,95598,368599,327010,1270988,422608,1639587
AM,201604,567429,2022949,521395,1952647,95092,366252,331729,1285571,426821,1651823
AM,201605,571582,2033665,524806,1962253,94931,365172,335237,1296338,430168,1661510
AM,201606,576138,2044452,527924,1970687,94325,362899,348421,1346549,442746,1709448
AM,201607,581605,2057840,531803,1981532,94379,362980,350735,1352210,445114,1715190
AM,201608,585516,2067397,534715,1989568,95474,366540,340062,1307053,435536,1673593
AM,201609,589328,2076299,529148,1977131,95769,367288,341897,1311524,437666,1678812
AM,201610,593977,2088164,531913,1985457,96252,369015,342523,1311443,438775,1680458
AM,201611,596866,2095255,533305,1989756,96934,371286,342208,1309604,439142,1680890
AM,201612,583440,2060697,522816,1958661,95467,367249,335334,1286515,430801,1653764
AM,201701,586114,2066426,536700,1991902,93295,359281,349579,1340759,442874,1700040
AM,201702,589432,2073867,539218,1998146,93405,358851,351767,1347090,445172,1705941
AM,201703,593087,2082107,542061,2005206,93562,358651,354043,1353488,447605,1712139
AM,201704,598913,2094033,546517,2015096,94188,359515,357067,1360750,451255,1720265
AM,201705,604488,2106107,550922,2025411,94832,360715,359366,1365718,454198,1726433
AM,201706,609568,2116517,554738,2033864,95583,362489,359785,1363370,455368,1725859
AM,201707,614196,2126338,558033,2041709,96004,362875,361615,1367745,457619,1730620
AM,201708,619531,2137724,561776,2050756,97628,366868,361833,1367224,459461,1734092
AM,201709,569086,1985667,516418,1907348,86035,326277,343937,1312304,429972,1638581
AM,201710,578427,2005447,522620,1922993,86884,327890,347977,1323154,434861,1651044
AM,201711,586516,2021224,527269,1934217,87096,327942,351553,1332107,438649,1660049
AM,201712,599323,2042815,531839,1945252,87272,328336,353907,1337070,441179,1665406
AM,201801,609295,2059394,536582,1955618,87397,328529,355403,1337815,442800,1666344
AM,201802,616297,2072805,541259,1965746,87734,328794,358361,1343710,446095,1672504
AM,201803,599611,2017078,525068,1910662,82404,309157,352718,1322776,435122,1631933
AM,201804,610083,2038063,532607,1927617,83241,310544,358123,1335788,441364,1646332
AM,201805,621957,2062258,541215,1947322,84007,311740,364311,1351181,448318,1662921
AM,201806,630302,2078966,547360,1961000,84836,313799,367795,1357903,452631,1671702
AM,201807,634270,2085954,550299,1966463,85970,317459,371757,1369512,457727,1686971
AM,201808,611798,2019790,532416,1907749,82408,304303,367081,1354193,449489,1658496
AM,201809,617951,2032737,537033,1918326,83685,308126,368281,1354521,451966,1662647
AM,201810,628162,2054219,544781,1936212,85091,312020,368997,1349044,454088,1661064
AM,201811,634309,2065109,548511,1943770,85895,314179,369717,1347567,455612,1661746
AM,201812,618548,2012879,534042,1894414,82340,301625,363545,1325897,445885,1627522
AM,201901,628632,2032461,540140,1910042,82312,300692,369016,1344263,451328,1644955
AM,201902,635369,2046586,544740,1921244,83058,302083,371557,1350608,454615,1652691
AM,201903,641431,2059732,549226,1932031,84127,305450,373108,1352224,457235,1657674
AM,201904,637895,2045299,544797,1915941,82723,300006,370926,1344443,453649,1644449
AM,201905,645328,2060876,550191,1928536,83545,301921,374019,1351074,457564,1652995
AM,201906,653026,2076692,555622,1941233,84321,303526,377238,1358886,461559,1662412
AM,201907,659854,2088844,559848,1949917,85255,305436,378700,1360884,463955,1666320
AM,201908,669196,2106941,565242,1962447,86427,308235,379916,1362092,466343,1670327
AM,201909,650175,2044359,547551,1903005,82153,292538,373880,1342697,456033,1635235
AM,201910,659574,2065404,553699,1919177,83425,295764,376581,1349837,460006,1645601
AM,201911,666237,2080760,557896,1930940,83998,296684,378935,1357559,462933,1654243
AM,201912,672788,2094857,561862,1941392,84461,297283,381051,1364035,465512,1661318
AM,202001,676928,2103749,567244,1953718,84681,297473,382413,1368218,467094,1665691
AM,202002,662974,2063953,555322,1918077,81860,286796,379799,1362741,461659,1649537
AM,202003,669062,2077919,559781,1929170,82544,288178,381730,1368959,464274,1657137
AM,202004,670798,2080212,561044,1930808,82692,288128,382631,1370325,465323,1658453
AM,202005,671608,2080482,561660,1930790,82703,287812,383022,1370174,465725,1657986
AM,202006,672568,2081307,562392,1931286,82696,287420,383531,1370677,466227,1658097
AM,202007,674465,2083334,563896,1932793,82851,287321,384442,1371349,467293,1658670
AM,202008,677999,2088455,566588,1936776,83353,287927,385684,1372520,469037,1660447
AM,202009,681068,2090116,568853,1937375,83975,288683,386540,1370460,470515,1659143
AM,202010,684807,2094807,571510,1940711,84582,289315,387718,1371555,472300,1660870
AM,202011,665050,2041524,556400,1894672,81332,278268,381506,1353729,462838,1631997
AM,202012,668164,2046349,558712,1898501,81784,278701,382711,1356021,464495,1634722
AP,201401,88256,321940,83496,313645,19585,71895,53872,210572,73457,282467
AP,201402,88801,323178,83921,314697,19713,72350,53940,210470,73653,282820
AP,201403,89555,324977,84429,315992,19740,72387,54126,210753,73866,283140
AP,201404,90371,327082,85055,317748,19854,72677,54358,211223,74212,283900
AP,201405,91209,329291,85755,319694,17781,64551,58458,225501,76239,290052
AP,201406,93045,334265,87318,324308,18101,65603,59436,228341,77537,293944
AP,201407,94247,337476,88368,327365,18371,66537,60081,230107,78452,296644
AP,201408,95911,342093,89870,331749,18880,68137,60857,232385,79737,300522
AP,201409,97264,345390,91072,334822,19259,69230,61484,233823,80743,303053
AP,201410,98756,349762,92278,338693,19620,70472,62107,235796,81727,306268
AP,201411,100119,353293,93112,341305,19944,71565,62296,236261,82240,307826
AP,201412,101212,356343,93897,343762,20241,72609,62468,236684,82709,309293
AP,201501,90541,323500,83714,312182,17600,64395,55196,213938,72796,278333
AP,201502,90713,323968,83873,312636,17602,64356,55326,214400,72928,278756
AP,201503,91430,325978,84529,314587,17675,64422,55829,216032,73504,280454
AP,201504,92359,328564,85359,317053,17858,64858,56267,217460,74125,282318
AP,201505,93165,330914,86072,319280,18061,65401,56441,218007,74502,283408
AP,201506,93660,332304,86526,320602,18301,66483,56319,216978,74620,283461
AP,201507,90926,322894,83668,310909,17636,64621,53845,207745,71481,272366
AP,201508,91718,325215,84276,312921,17919,65745,53616,206662,71535,272407
AP,201509,92396,327014,84852,314558,18217,66738,53606,206317,71823,273055
AP,201510,93033,328753,85376,316112,18444,67531,53652,206221,72096,273752
AP,201511,93665,330224,85912,317439,18667,68306,53765,206246,72432,274552
AP,201512,94439,332227,86610,319365,18827,68973,54166,207136,72993,276109
AP,201601,91450,324059,84522,313292,18091,66727,52394,202377,70485,269104
AP,201602,92016,325562,85017,314718,17995,66528,53018,204237,71013,270765
AP,201603,92678,327110,85461,315960,17697,65646,53613,205928,71310,271574
AP,201604,93364,328882,85979,317494,17437,64834,54286,207960,71723,272794
AP,201605,94309,331037,86555,319120,17201,64019,54819,209682,72020,273701
AP,201606,95719,334434,87623,322032,16502,61116,57971,221535,74473,282651
AP,201607,96922,337426,88624,324741,16593,61112,58525,223075,75118,284187
AP,201608,97968,340071,89505,327174,17436,64155,56519,214483,73955,278638
AP,201609,98748,341746,88815,325663,17611,64554,56742,214977,74353,279531
AP,201610,99622,343798,89365,327159,17599,64410,57117,215988,74716,280398
AP,201611,100071,345010,89700,328177,17698,64661,57287,216508,74985,281169
AP,201612,98239,340297,88197,323783,17338,63555,56456,213852,73794,277407
AP,201701,98850,341837,90702,329724,16485,60056,59414,225089,75899,285145
AP,201702,99365,343019,91135,330789,16500,60049,59687,225757,76187,285806
AP,201703,99838,344169,91528,331818,16618,60405,59929,226391,76547,286796
AP,201704,100644,345721,92208,333209,16671,60353,60359,227332,77030,287685
AP,201705,101512,347715,92963,335020,16739,60344,60846,228648,77585,288992
AP,201706,102299,349161,93624,336269,16864,60379,60956,228417,77820,288796
AP,201707,103462,351861,94623,338701,17092,60842,61470,229712,78562,290554
AP,201708,104595,354296,95616,340959,17309,60981,62017,231277,79326,292258
AP,201709,99866,339140,91397,326677,16059,56312,60409,225751,76468,282063
AP,201710,102147,343612,93299,330666,16197,56333,61978,229375,78175,285708
AP,201711,104487,347611,94740,333540,16304,56401,63065,231678,79369,288079
AP,201712,107371,352060,96064,336171,16314,56276,63989,233370,80303,289646
AP,201801,111440,358270,98307,340323,16494,56377,65189,235411,81683,291788
AP,201802,113710,362018,99447,342795,16604,56445,65832,236919,82436,293364
AP,201803,111031,353138,97089,334794,15756,53464,65190,234812,80946,288276
AP,201804,112930,356729,98337,337553,15736,53104,66125,237408,81861,290512
AP,201805,114990,361119,99807,341192,15730,52721,67299,240847,83029,293568
AP,201806,116555,364327,101032,343950,15827,52758,68170,243014,83997,295772
AP,201807,117661,366487,101898,345798,15876,52518,69322,246638,85198,299156
AP,201808,115398,359102,100022,339125,15286,50442,69041,245245,84327,295687
AP,201809,117321,362566,101386,341825,15408,50693,69823,246635,85231,297328
AP,201810,118926,365990,102532,344586,15484,51005,69819,245754,85303,296759
AP,201811,121084,370410,104064,348090,15768,51630,70493,247139,86261,298769
AP,201812,119950,365984,102914,343644,15331,50033,70006,244996,85337,295029
AP,201901,122768,371753,104900,348577,15539,50277,71348,248994,86887,299271
AP,201902,124805,376265,106507,352452,15787,50894,72217,251178,88004,302072
AP,201903,126676,380293,108016,355956,16044,51502,72871,252587,88915,304089
AP,201904,126798,380279,108051,355819,15790,50631,73227,253564,89017,304195
AP,201905,128257,383332,109099,358304,15829,50780,74047,255408,89876,306188
AP,201906,130977,389116,110980,362964,16203,51686,75040,258013,91243,309699
AP,201907,132985,392972,112132,365630,16378,52045,75536,259120,91914,311165
AP,201908,135408,398157,113660,369518,16624,52539,76208,260754,92832,313293
AP,201909,132510,388858,110838,360506,15916,50087,75408,258267,91324,308354
AP,201910,134743,394060,112368,364741,16133,50693,76330,260857,92463,311550
AP,201911,136319,397762,113419,367736,16276,51027,76966,262858,93242,313885
AP,201912,137448,400211,114082,369594,16277,50834,77475,264471,93752,315305
AP,202001,138341,401884,115534,372365,16320,50896,77758,265146,94078,316042
AP,202002,136506,396454,113730,367207,15814,49149,77460,264463,93274,313612
AP,202003,137993,399802,114819,369892,15995,49540,77847,265662,93842,315202
AP,202004,138285,400195,115053,370207,16014,49551,78028,265916,94042,315467
AP,202005,138809,401003,115541,370968,16107,49698,78335,266356,94442,316054
AP,202006,139108,401421,115808,371333,16178,49826,78403,266365,94581,316191
AP,202007,139751,402307,116363,372099,16326,50081,78620,266587,94946,316668
AP,202008,140463,403352,116989,373000,16462,50280,78875,266845,95337,317125
AP,202009,141788,405909,118154,375266,16718,50855,79274,267267,95992,318122
AP,202010,144267,411912,120249,380487,17163,52009,79985,268756,97148,320765
AP,202011,140563,402809,117507,372762,16661,50559,78961,265755,95622,316314
AP,202012,141211,403868,118067,373705,16754,50714,79225,266159,95979,316873
BA,201401,3065481,9112783,2780205,8701729,453423,1500397,1880159,5958188,2333582,7458585
BA,201402,3081252,9132123,2788519,8708861,454326,1499894,1879214,5940641,2333540,7440535
BA,201403,3098474,9151499,2797280,8714371,454472,1495572,1877055,5916839,2331527,7412411
BA,201404,3116097,9173757,2807408,8724800,454792,1491597,1877588,5902689,2332380,7394286
BA,201405,3131294,9192713,2815752,8732871,439402,1422053,1946311,6107691,2385713,7529744
BA,201406,3149009,9215206,2825486,8742799,440570,1423492,1947916,6096350,2388486,7519842
BA,201407,3162594,9235295,2833982,8754780,441376,1424442,1951458,6095936,2392834,7520378
BA,201408,3188821,9275209,2851594,8780851,443567,1427907,1959053,6097358,2402620,7525265
BA,201409,3205030,9289774,2861170,8785081,445468,1430508,1960339,6082750,2405807,7513258
BA,201410,3223601,9325755,2872572,8809316,447568,1435948,1963913,6084337,2411481,7520285
BA,201411,3239918,9353197,2882968,8826777,449092,1438382,1967572,6085410,2416664,7523792
BA,201412,3254402,9376075,2890949,8838538,450640,1440992,1967806,6078071,2418446,7519063
BA,201501,3001627,8696893,2676182,8223321,371159,1203621,1863076,5771178,2234235,6974799
BA,201502,3020462,8732279,2687846,8246771,373012,1205891,1864948,5771332,2237960,6977223
BA,201503,3038563,8762910,2696522,8261024,374512,1206598,1863623,5760055,2238135,6966653
BA,201504,3053907,8789233,2703579,8273163,375649,1206321,1862328,5751551,2237977,6957872
BA,201505,3070425,8818159,2712591,8289359,375086,1201155,1862875,5745402,2237961,6946557
BA,201506,3082250,8831428,2716687,8288837,375870,1201550,1849072,5687347,2224942,6888897
BA,201507,2971841,8537026,2620983,8010146,354755,1135855,1786137,5492668,2140892,6628523
BA,201508,2990637,8568592,2630345,8025750,358153,1143535,1775743,5448086,2133896,6591621
BA,201509,3003328,8585703,2636435,8031993,360833,1149291,1768063,5414876,2128896,6564167
BA,201510,3015514,8602393,2642577,8038892,363380,1156031,1762572,5388866,2125952,6544897
BA,201511,3028090,8621670,2649979,8049962,364722,1157705,1762292,5381282,2127014,6538987
BA,201512,3042783,8645453,2658907,8064101,364914,1155186,1765585,5383605,2130499,6538791
BA,201601,2965874,8495516,2619809,7986922,353411,1127761,1721796,5295466,2075207,6423227
BA,201602,2978713,8518855,2628692,8003453,351476,1120669,1729981,5313364,2081457,6434033
BA,201603,2998473,8554286,2642898,8030050,348595,1109078,1743502,5343520,2092097,6452598
BA,201604,3020377,8590408,2659166,8057521,344985,1094616,1760224,5378557,2105209,6473173
BA,201605,3039368,8624816,2673626,8084820,343549,1087275,1773279,5407062,2116828,6494337
BA,201606,3054821,8645252,2682602,8094775,343557,1117710,1823018,5543757,2166575,6661467
BA,201607,3069591,8666739,2691468,8106467,342205,1109284,1825379,5539731,2167584,6649015
BA,201608,3085660,8686599,2700134,8113760,345428,1079981,1775275,5376133,2120703,6456114
BA,201609,3100256,8708502,2652219,7999009,347821,1083108,1776286,5368295,2124107,6451403
BA,201610,3114736,8728359,2656027,7997371,351683,1090442,1771305,5339322,2122988,6429764
BA,201611,3124091,8740326,2656720,7992149,355298,1097152,1765087,5313666,2120385,6410818
BA,201612,2961792,8368795,2531538,7663466,335775,1040379,1695949,5125063,2031724,6165442
BA,201701,2972292,8385666,2619852,7859590,314394,1011061,1762373,5307130,2076767,6318191
BA,201702,2987442,8408655,2630698,7875773,312731,1001911,1772758,5327775,2085489,6329686
BA,201703,3006514,8438751,2644657,7897688,312039,994797,1785309,5352656,2097348,6347453
BA,201704,3033013,8480679,2663507,7927245,311689,986862,1799606,5377847,2111295,6364709
BA,201705,3057267,8517100,2680630,7952490,311880,981812,1809569,5388143,2121449,6369955
BA,201706,3076425,8538605,2692829,7962724,313017,980353,1808988,5362399,2122005,6342752
BA,201707,3096977,8570907,2705065,7981700,314323,980058,1814016,5365471,2128339,6345529
BA,201708,3122416,8609202,2720019,8003774,316251,981142,1821016,5370581,2137267,6351723
BA,201709,2895828,8054125,2540305,7516699,282864,877831,1748314,5188256,2031178,6066087
BA,201710,2939281,8127245,2565080,7562222,283311,875169,1765653,5219323,2048964,6094492
BA,201711,2979549,8193200,2583815,7598229,282629,870458,1778369,5242801,2060998,6113259
BA,201712,3031154,8272987,2601784,7632915,281424,865149,1787879,5255305,2069303,6120454
BA,201801,3060058,8319862,2619373,7666589,281501,864113,1792301,5252489,2073802,6116602
BA,201802,3085180,8362619,2634554,7693003,281877,862639,1800967,5263670,2082844,6126309
BA,201803,3008248,8162846,2569672,7505418,265203,810352,1769871,5169865,2035074,5980217
BA,201804,3035921,8213089,2589150,7542136,265726,808854,1783685,5195346,2049411,6004200
BA,201805,3070825,8275376,2614270,7588843,265420,803852,1802736,5231990,2068156,6035842
BA,201806,3093770,8311959,2629495,7613323,266330,804889,1809426,5235072,2075756,6039961
BA,201807,3107042,8329750,2638682,7624483,270469,822000,1819938,5254621,2090407,6076621
BA,201808,2983015,8015737,2549150,7362755,255545,774955,1801185,5197315,2056730,5972270
BA,201809,3012165,8060686,2568481,7392474,257904,779157,1807914,5193597,2065818,5972754
BA,201810,3052057,8128506,2595190,7439937,260618,778453,1810741,5176462,2071359,5954915
BA,201811,3079003,8168913,2610356,7462888,262104,780684,1815912,5174375,2078016,5955059
BA,201812,2996335,7947487,2536749,7257859,246367,735191,1782318,5083150,2028685,5818341
BA,201901,3029880,8010373,2560211,7313416,242103,725701,1802319,5134534,2044422,5860235
BA,201902,3060957,8068959,2579416,7352622,241920,722831,1813798,5155566,2055718,5878397
BA,201903,3083650,8107845,2594022,7378427,242536,724299,1819570,5156326,2062106,5880625
BA,201904,3044125,8016135,2562175,7294280,234098,698635,1802190,5111944,2036288,5810579
BA,201905,3072820,8066459,2582134,7330851,235081,698987,1814062,5129566,2049143,5828553
BA,201906,3101410,8116712,2600474,7365783,235560,698384,1825877,5150063,2061437,5848447
BA,201907,3120398,8146708,2610853,7383155,236164,698837,1829780,5151731,2065944,5850568
BA,201908,3157357,8208055,2629757,7416370,237152,698448,1837100,5156059,2074252,5854507
BA,201909,3061916,7939137,2546936,7171123,222317,654480,1810424,5079491,2032741,5733971
BA,201910,3105152,8020967,2572962,7225777,224264,657294,1823222,5102166,2047486,5759460
BA,201911,3136836,8083161,2592224,7268827,224926,656850,1834249,5126181,2059175,5783031
BA,201912,3168401,8145165,2611377,7311383,225354,655320,1845029,5149686,2070383,5805006
BA,202001,3186761,8181759,2635468,7363515,225813,655578,1850464,5161528,2076277,5817106
BA,202002,3105820,7987374,2572371,7203928,215990,626751,1834897,5127489,2050887,5754240
BA,202003,3131911,8038269,2591148,7238844,216844,627245,1842923,5144892,2059767,5772137
BA,202004,3142281,8052674,2598677,7249039,217658,627800,1847419,5149945,2065077,5777745
BA,202005,3155987,8072241,2610132,7265358,218936,629336,1853586,5156444,2072522,5785780
BA,202006,3164921,8087159,2617229,7277380,219880,630743,1856264,5159471,2076144,5790214
BA,202007,3172969,8099480,2623434,7286855,220766,632151,1858926,5162101,2079692,5794252
BA,202008,3183662,8115862,2631583,7299472,222043,634041,1862663,5166258,2084706,5800299
BA,202009,3193680,8126168,2639100,7306173,223334,635799,1865785,5164488,2089119,5800287
BA,202010,3208002,8146540,2649738,7321227,224839,637408,1871498,5171026,2096337,5808434
BA,202011,3114663,7933212,2585198,7154692,215510,612343,1846029,5111176,2061539,5723519
BA,202012,3126870,7952796,2594433,7170007,216707,613782,1851843,5120958,2068550,5734740
CE,201401,1799054,5768414,1657569,5516354,303040,1108992,1010252,3362497,1313292,4471489
CE,201402,1805453,5772272,1659438,5511054,301690,1101039,1006781,3343507,1308471,4444546
CE,201403,1810621,5771170,1659971,5500389,300086,1091451,1000989,3316149,1301075,4407600
CE,201404,1817798,5779652,1663574,5501705,299109,1085150,1000024,3305509,1299133,4390659
CE,201405,1824571,5786516,1666652,5501496,294582,1059358,1038514,3431063,1333096,4490421
CE,201406,1833183,5794603,1670260,5500010,293764,1054036,1038223,3420804,1331987,4474840
CE,201407,1839986,5800835,1672890,5497958,292686,1048559,1038100,3413068,1330786,4461627
CE,201408,1851076,5813270,1678058,5498975,292304,1044301,1039046,3405588,1331350,4449889
CE,201409,1860792,5820725,1683109,5497883,293212,1043376,1038910,3394924,1332122,4438300
CE,201410,1869678,5840771,1687786,5509288,293662,1044289,1039511,3393541,1333173,4437830
CE,201411,1876213,5850502,1691104,5512635,294183,1044329,1039311,3388481,1333494,4432810
CE,201412,1882907,5860222,1694360,5515817,294949,1044828,1038698,3382608,1333647,4427436
CE,201501,1770263,5533109,1601804,5233086,255929,918698,998339,3258315,1254268,4177013
CE,201502,1779244,5549378,1607794,5243749,256510,918083,998073,3253693,1254583,4171776
CE,201503,1788334,5564344,1613231,5251392,257089,916750,997275,3245999,1254364,4162749
CE,201504,1794696,5574852,1617030,5256894,257681,916344,996414,3239552,1254095,4155896
CE,201505,1803175,5588778,1622001,5264059,257336,912284,995871,3232445,1253207,4144729
CE,201506,1809648,5595533,1624448,5262622,257729,911690,986263,3191099,1243992,4102789
CE,201507,1758039,5434910,1575932,5103937,245582,867567,953404,3076867,1198986,3944434
CE,201508,1768060,5450168,1580320,5107702,246707,867746,944163,3038578,1190870,3906324
CE,201509,1775752,5460199,1583869,5109635,247783,868110,939053,3016076,1186836,3884186
CE,201510,1781764,5467386,1586609,5110654,248964,869911,935074,2998405,1184038,3868316
CE,201511,1787684,5473154,1589965,5111847,249239,868130,934695,2992029,1183934,3860159
CE,201512,1794637,5482307,1593698,5114771,248505,863326,935920,2990904,1184425,3854230
CE,201601,1745604,5375949,1571184,5066203,240743,840757,914076,2945785,1154819,3786542
CE,201602,1753008,5388504,1575749,5073097,239367,835107,919316,2957438,1158683,3792545
CE,201603,1762583,5404764,1582142,5083331,237715,827087,925996,2972453,1163711,3799540
CE,201604,1772887,5422440,1589490,5095384,236407,820174,932941,2987450,1169348,3807624
CE,201605,1782409,5439854,1596213,5107622,235615,814886,938896,3001633,1174511,3816519
CE,201606,1791453,5451598,1601328,5111924,245463,866651,967571,3090715,1213034,3957366
CE,201607,1802640,5468648,1607397,5119350,244154,858954,968452,3085487,1212606,3944441
CE,201608,1811852,5481507,1612132,5123398,235061,803395,940410,2984519,1175471,3787914
CE,201609,1820179,5493234,1576788,5030962,235316,801172,941370,2980890,1176686,3782062
CE,201610,1828773,5504324,1577005,5023575,235641,798182,939616,2967146,1175257,3765328
CE,201611,1834843,5511501,1576124,5015518,236365,797212,937228,2954295,1173593,3751507
CE,201612,1759041,5316369,1515190,4840090,225751,761216,911229,2878924,1136980,3640140
CE,201701,1764881,5324877,1577887,4989136,223586,777029,947882,2990005,1171468,3767034
CE,201702,1772169,5336059,1583080,4996606,222389,770556,953196,3001761,1175585,3772317
CE,201703,1779809,5347817,1588590,5004525,221622,765130,958576,3013356,1180198,3778486
CE,201704,1790259,5361588,1596107,5013158,220622,757272,965682,3026848,1186304,3784120
CE,201705,1800662,5377528,1603478,5023463,219814,750316,970304,3032289,1190118,3782605
CE,201706,1809958,5385030,1609368,5024676,218977,741948,970127,3017528,1189104,3759476
CE,201707,1822690,5402483,1616769,5032703,218345,735242,974931,3023283,1193276,3758525
CE,201708,1836646,5423595,1624685,5043408,218090,729977,979942,3031579,1198032,3761556
CE,201709,1708183,5063719,1515292,4717870,194290,648184,945767,2939341,1140057,3587525
CE,201710,1739095,5119491,1530658,4749263,193000,641025,956663,2962987,1149663,3604012
CE,201711,1763473,5164015,1542075,4773402,191580,634487,964802,2981149,1156382,3615636
CE,201712,1787127,5204861,1552007,4792953,189934,627557,971249,2992298,1161183,3619855
CE,201801,1802974,5231874,1562557,4813884,188847,622951,974299,2991991,1163146,3614942
CE,201802,1815631,5254248,1570502,4827651,187878,618426,980173,3001553,1168051,3619979
CE,201803,1772595,5130295,1533847,4711524,176285,578157,968701,2963120,1144986,3541277
CE,201804,1786601,5157516,1544038,4731504,175776,574899,977368,2981263,1153144,3556162
CE,201805,1805216,5193072,1557595,4757876,174528,568622,990037,3009125,1164565,3577747
CE,201806,1818996,5216287,1566908,4773516,174308,566437,995777,3016448,1170085,3582885
CE,201807,1829179,5231068,1573811,4782669,178597,583160,1003186,3031332,1181783,3614492
CE,201808,1755750,5022255,1517480,4605934,168213,547502,996948,3009106,1165161,3556608
CE,201809,1772889,5052186,1528984,4626011,168281,545602,1002364,3012877,1170645,3558479
CE,201810,1794760,5092395,1543999,4654419,166114,533966,1006176,3007987,1172290,3541953
CE,201811,1809373,5116281,1552875,4668991,166081,532870,1010519,3010872,1176600,3543742
CE,201812,1769940,5001938,1516681,4562917,156667,502890,997490,2974482,1154157,3477372
CE,201901,1788798,5039857,1532545,4603024,156660,504358,1006687,3000003,1163347,3504361
CE,201902,1805372,5073498,1543272,4626090,156263,501588,1013699,3014300,1169962,3515888
CE,201903,1819090,5099318,1552727,4644383,156152,500571,1018444,3019352,1174596,3519923
CE,201904,1799360,5049609,1536041,4597929,150846,484642,1012153,3001349,1162999,3485991
CE,201905,1815828,5081064,1547213,4620018,150627,483081,1019745,3014323,1170372,3497404
CE,201906,1833294,5114782,1558504,4643341,150368,480882,1027487,3029625,1177855,3510507
CE,201907,1848454,5141336,1567127,4659471,150466,479787,1031617,3034799,1182083,3514586
CE,201908,1867750,5175701,1576256,4676636,149945,476459,1034971,3036357,1184916,3512816
CE,201909,1808466,4997417,1522778,4512734,140161,445644,1021592,2997313,1161753,3442957
CE,201910,1832635,5047620,1537051,4545262,140523,445125,1029311,3012662,1169834,3457787
CE,201911,1849553,5083611,1547449,4569856,140356,443613,1036309,3028623,1176665,3472236
CE,201912,1865205,5117368,1556628,4592180,140279,442485,1042113,3042184,1182392,3484669
CE,202001,1876079,5141530,1572946,4631115,140516,442810,1044822,3048408,1185338,3491218
CE,202002,1830831,5022320,1535333,4531666,135046,425556,1037778,3032858,1172824,3458414
CE,202003,1845622,5055098,1546926,4554730,135469,426035,1042483,3043982,1177952,3470017
CE,202004,1849203,5061018,1549449,4558856,135608,426040,1044117,3046266,1179725,3472306
CE,202005,1852337,5065441,1552145,4562715,135834,426124,1045758,3048020,1181592,3474144
CE,202006,1855216,5070024,1554486,4566475,136108,426427,1047063,3049671,1183171,3476098
CE,202007,1859439,5075576,1557811,4570698,136510,426887,1048569,3049917,1185079,3476804
CE,202008,1869279,5091199,1565760,4583494,137534,428498,1053545,3056751,1191079,3485249
CE,202009,1878847,5103295,1573360,4592447,138429,429351,1057875,3059381,1196304,3488732
CE,202010,1891694,5121972,1583317,4606729,139386,429800,1064578,3068443,1203964,3498243
CE,202011,1842392,4996812,1549131,4509355,134347,414589,1055190,3043574,1189537,3458163
CE,202012,1853172,5015357,1557743,4524467,135378,416133,1060931,3053523,1196309,3469656
DF,201401,251170,826850,227872,780423,70527,267168,74525,253775,145052,520943
DF,201402,252122,828153,228496,781136,70558,266945,74761,253565,145319,520510
DF,201403,254008,831633,229711,783459,70556,266351,75339,254726,145895,521077
DF,201404,254754,832589,229938,783511,70395,265457,75531,255035,145926,520492
DF,201405,255428,833691,230219,783906,72279,268751,83089,282846,155368,551597
DF,201406,257248,837559,231589,786986,72401,268467,83639,283902,156040,552369
DF,201407,258224,839324,232166,787951,72511,268563,83834,283966,156345,552529
DF,201408,259192,840596,232504,787971,72354,267420,83917,283789,156271,551209
DF,201409,259972,838399,232777,784912,72162,265261,83974,282236,156136,547497
DF,201410,262383,846746,234269,791442,72293,266305,84681,284940,156974,551245
DF,201411,264242,850555,235354,793888,72440,266341,85181,286044,157621,552385
DF,201412,265856,853998,236294,796104,72515,266313,85703,287324,158218,553637
DF,201501,236098,748432,210875,703251,59915,221677,72637,238071,132552,459748
DF,201502,237049,750425,211539,704714,60030,221881,72857,238382,132887,460263
DF,201503,238116,752613,212240,706187,60112,221852,73190,239082,133302,460934
DF,201504,239263,755251,213055,708211,60270,222153,73560,239962,133830,462115
DF,201505,240821,758599,214009,710431,60311,221997,74085,241192,134396,463189
DF,201506,241333,759313,214190,710479,60128,221106,73871,240023,133999,461129
DF,201507,228117,716469,201476,668120,56159,206568,68361,220335,124520,426903
DF,201508,229742,720126,202338,670192,56074,205850,68431,219937,124505,425787
DF,201509,230910,722523,202946,671492,56010,205232,68423,219519,124433,424751
DF,201510,231897,724237,203401,672151,55856,204475,68463,219089,124319,423564
DF,201511,232468,724980,203570,672104,55736,203817,68361,218472,124097,422289
DF,201512,233888,727450,204148,673069,55529,202648,68429,218217,123958,420865
DF,201601,214723,673957,191197,633627,51574,188976,63030,204757,114604,393733
DF,201602,216537,677641,192135,635797,51511,188502,63248,204921,114759,393423
DF,201603,218055,680722,193131,637884,51406,187776,63889,206419,115295,394195
DF,201604,219571,683803,194106,639983,51145,186541,64651,208315,115796,394856
DF,201605,220677,686168,194772,641510,51040,185873,65262,210086,116302,395959
DF,201606,222419,689907,196061,644468,53821,196356,71011,230634,124832,426990
DF,201607,224564,694530,197597,648009,53733,195712,72184,233514,125917,429226
DF,201608,225972,697202,198485,649765,51090,184598,67315,214667,118405,399265
DF,201609,227767,700822,193524,637253,51152,184362,67974,215980,119126,400342
DF,201610,230110,705535,194913,640294,51225,184079,68669,217106,119894,401185
DF,201611,230849,706726,195272,640863,51202,183904,68963,217628,120165,401532
DF,201612,184168,569696,155537,516510,42041,152546,62347,197683,104388,350229
DF,201701,185388,572384,163342,535479,42507,155322,67619,216032,110126,371354
DF,201702,186319,574213,163982,536807,42410,154808,68002,216824,110412,371632
DF,201703,187252,576122,164664,538268,42380,154497,68426,217704,110806,372201
DF,201704,188873,579677,165907,541091,42376,154151,69235,219689,111611,373840
DF,201705,190518,583378,167269,544278,42480,154168,70179,221990,112659,376158
DF,201706,192276,586982,168681,547224,42506,153757,70857,223137,113363,376894
DF,201707,194025,590625,170062,550156,42379,152735,71637,224701,114016,377436
DF,201708,195340,593311,171064,552222,42422,152514,72196,225874,114618,378388
DF,201709,166292,501078,144850,465282,34187,121927,65928,206628,100115,328555
DF,201710,169134,507902,147020,470834,34227,121691,67312,210207,101539,331898
DF,201711,171359,513168,148641,475052,34258,121510,68477,213320,102735,334830
DF,201712,174051,519223,150405,479650,34320,121415,69601,216380,103921,337795
DF,201801,175780,523014,151923,483538,34289,121033,70136,217750,104425,338783
DF,201802,177147,525748,152822,485493,34181,120448,70690,218987,104871,339435
DF,201803,165241,488826,141953,450104,30208,105778,67642,209585,97850,315363
DF,201804,165964,490359,142506,451295,30208,105639,68088,210609,98296,316248
DF,201805,166637,491823,142976,452361,30223,105533,68437,211443,98660,316976
DF,201806,168301,495504,144230,455337,30301,105528,69214,213263,99515,318791
DF,201807,170028,499373,145529,458466,30692,106937,71057,219114,101749,326051
DF,201808,154926,455132,133781,420254,28143,97744,69879,215329,98022,313073
DF,201809,156875,459443,135314,423759,28297,97937,70602,216720,98899,314657
DF,201810,159648,465416,137155,428153,28420,97862,70228,214029,98648,311891
DF,201811,162163,470550,138614,431672,28547,98098,70769,215002,99316,313100
DF,201812,148848,428097,125748,390867,24457,83545,67114,204648,91571,288193
DF,201901,152603,435606,127896,396743,24433,83468,68403,208731,92836,292199
DF,201902,154734,440355,129315,400368,24559,83724,69143,210491,93702,294215
DF,201903,156259,443765,130423,403028,24567,83664,69815,211960,94382,295624
DF,201904,151270,429603,125720,389294,22999,78308,67776,206411,90775,284719
DF,201905,154278,436836,128032,395307,23212,78784,69120,209605,92332,288389
DF,201906,158280,446491,131172,403601,23571,79627,71091,214613,94662,294240
DF,201907,162262,455209,133983,410584,23798,80073,72822,218786,96620,298859
DF,201908,167872,467672,137777,420358,24059,80527,75078,224348,99137,304875
DF,201909,158948,435674,128976,389379,21307,70253,73147,217275,94454,287528
DF,201910,164380,448092,132718,399242,21685,71189,75442,222995,97127,294184
DF,201911,167453,454848,134722,404437,21836,71523,76699,226143,98535,297666
DF,201912,170094,460653,136260,408575,21935,71767,77440,228074,99375,299841
DF,202001,171969,464680,138599,414256,22028,72044,77947,229387,99975,301431
DF,202002,164970,444029,132439,396150,20764,67950,77060,227191,97824,295141
DF,202003,167523,449639,134210,400341,20893,68238,77928,229382,98821,297620
DF,202004,167759,450014,134330,400592,20904,68245,77987,229475,98891,297720
DF,202005,167752,449759,134321,400338,20889,68179,78006,229358,98895,297537
DF,202006,168014,450227,134517,400714,20893,68169,78151,229624,99044,297793
DF,202007,168790,451723,135043,401837,20925,68238,78447,230099,99372,298337
DF,202008,170081,454344,135924,403832,20993,68384,78986,231105,99979,299489
DF,202009,170937,455971,136562,405131,21004,68323,79454,231994,100458,300317
DF,202010,171955,458072,137353,406884,21075,68485,80007,233145,101082,301630
DF,202011,160947,429457,128891,382569,19198,62546,77454,226341,96652,288887
DF,202012,161573,430650,129421,383639,19267,62669,77778,226919,97045,289588
ES,201401,456673,1468442,397968,1352504,120629,448698,152559,505557,273188,954255
ES,201402,464576,1485572,400878,1359058,120615,447933,152251,502991,272866,950924
ES,201403,469062,1494652,402830,1362549,120527,446788,151664,499070,272191,945858
ES,201404,471582,1499108,403516,1362943,119948,443800,150899,495341,270847,939141
ES,201405,474150,1503642,404281,1363444,120009,440622,164369,542767,284378,983389
ES,201406,478343,1512238,406068,1366944,120143,440240,164123,540465,284266,980705
ES,201407,480155,1514564,406401,1365994,119948,438809,163514,537207,283462,976016
ES,201408,483725,1521188,407687,1367608,119916,438213,163047,533634,282963,971847
ES,201409,486078,1519879,407778,1361851,119838,435915,161719,526547,281557,962462
ES,201410,488661,1527218,408138,1364153,119475,435344,161154,524330,280629,959674
ES,201411,490599,1530587,408697,1364457,119325,434492,160850,522305,280175,956797
ES,201412,493328,1536060,409779,1366267,119328,434292,160600,520322,279928,954614
ES,201501,447870,1383163,372626,1234674,100321,366626,144584,464306,244905,830932
ES,201502,450805,1389630,374060,1237914,100394,366453,144639,463752,245033,830205
ES,201503,454491,1398295,375935,1242660,100692,366983,144090,461144,244782,828127
ES,201504,457244,1404212,377340,1245738,101037,367446,143562,458399,244599,825845
ES,201505,461078,1412845,379351,1250542,101089,366955,143582,457443,244671,824398
ES,201506,463636,1418325,380533,1253013,100972,365970,142821,453911,243793,819881
ES,201507,445132,1359765,363684,1196142,95351,344576,136015,431146,231366,775722
ES,201508,448561,1367945,365192,1199913,95303,343771,135015,426619,230318,770390
ES,201509,451051,1373397,366370,1202484,95286,342911,134061,422740,229347,765651
ES,201510,453629,1379220,367868,1205882,95451,342923,133665,420392,229116,763315
ES,201511,456168,1384882,369405,1209458,95579,342772,133628,419612,229207,762384
ES,201512,459492,1393361,371323,1214863,95701,342632,133741,419600,229442,762232
ES,201601,434451,1328342,359792,1183313,90577,325777,122829,392738,213406,718515
ES,201602,436628,1333237,360978,1186175,90786,326213,123366,394020,214152,720233
ES,201603,440122,1341386,362989,1191335,90726,325640,124401,396809,215127,722449
ES,201604,444591,1351114,365579,1197451,90719,324973,125558,399338,216277,724311
ES,201605,447570,1357570,367546,1201973,90677,324257,126716,402154,217393,726411
ES,201606,450483,1364041,369103,1205527,95325,342264,136514,437434,231839,779698
ES,201607,453703,1371859,370960,1210461,95131,341022,137188,439074,232319,780096
ES,201608,456262,1377638,372305,1213536,90381,321305,128105,404761,218486,726066
ES,201609,458828,1383232,358038,1175806,90455,320915,128555,405410,219010,726325
ES,201610,462172,1390796,359193,1178377,90367,319722,128706,404646,219073,724368
ES,201611,464188,1395362,359795,1179730,90398,319349,128442,403032,218840,722381
ES,201612,430497,1301974,333555,1099493,84025,297241,120909,380499,204934,677740
ES,201701,432784,1307085,356513,1159677,87266,310505,130740,415124,218006,725629
ES,201702,434156,1309763,357388,1161257,87277,310320,131301,416184,218578,726504
ES,201703,436582,1315023,359043,1164965,87338,309933,132492,419228,219830,729161
ES,201704,440338,1323558,361664,1171083,87345,309096,134326,424048,221671,733144
ES,201705,444186,1331833,364221,1176936,87414,308478,135646,426883,223060,735361
ES,201706,447185,1337779,365888,1180224,87173,306715,135978,426492,223151,733207
ES,201707,450524,1344148,367635,1183407,86932,305173,136829,427922,223761,733095
ES,201708,454892,1353438,370088,1189063,87001,304557,138032,430414,225033,734971
ES,201709,392573,1168512,320133,1030119,74550,260660,126593,397126,201143,657786
ES,201710,400143,1185313,324511,1041335,74882,261142,129166,403622,204048,664764
ES,201711,406671,1199331,328087,1050216,74981,260948,131469,409444,206450,670392
ES,201712,415626,1217715,331657,1059659,74748,259799,133654,415129,208402,674928
ES,201801,422687,1232931,336075,1071431,74764,259561,135260,418852,210024,678413
ES,201802,426986,1242883,338792,1078035,74839,259480,136996,422912,211835,682392
ES,201803,408292,1185856,322169,1023375,68862,237672,133321,410763,202183,648435
ES,201804,416956,1207383,327390,1037448,69290,238485,135569,416348,204859,654833
ES,201805,425961,1229344,333347,1053053,69859,239693,138797,424408,208656,664101
ES,201806,432672,1245956,337893,1065350,70265,240507,141110,430422,211375,670929
ES,201807,437447,1257542,341066,1073659,72137,246928,144783,442191,216920,689119
ES,201808,409260,1176248,320466,1007906,68356,233978,142716,436019,211072,669997
ES,201809,416646,1193411,325097,1019517,68806,234622,144387,439098,213193,673720
ES,201810,426425,1215978,331135,1034770,68419,232242,144414,435120,212833,667362
ES,201811,432658,1229746,334699,1043366,68849,233256,145438,436387,214287,669643
ES,201812,414733,1175825,319901,996067,64589,218689,141926,426091,206515,644780
ES,201901,421877,1192393,326480,1014459,65625,221912,145902,438470,211527,660382
ES,201902,428687,1208151,330876,1025551,66067,222964,148142,443608,214209,666572
ES,201903,434604,1221996,334829,1035359,66450,223664,149946,447477,216396,671141
ES,201904,430989,1211769,331492,1024979,64970,218461,149069,444904,214039,663365
ES,201905,438866,1230106,336331,1037166,65432,219482,151174,449429,216606,668911
ES,201906,447034,1249201,341227,1049633,65984,221226,153341,453776,219325,675002
ES,201907,453362,1263114,344891,1058488,66470,222384,154715,456194,221185,678578
ES,201908,461664,1281463,349552,1069753,67061,223787,156222,458670,223283,682457
ES,201909,441615,1216926,332393,1012220,63214,210652,152815,447339,216029,657991
ES,201910,451785,1241121,338602,1028414,63980,212735,155477,453290,219457,666025
ES,201911,458775,1257636,342961,1039917,64364,213570,157614,458535,221978,672105
ES,201912,465352,1273464,346947,1050684,64697,214364,159536,463238,224233,677602
ES,202001,468899,1281455,354010,1068007,64816,214614,160458,465392,225274,680006
ES,202002,454747,1238133,342850,1033838,62612,207325,159239,461806,221851,669131
ES,202003,461521,1254006,347185,1043756,62917,208062,160746,465379,223663,673441
ES,202004,463878,1259275,348708,1047366,63073,208386,161358,466631,224431,675017
ES,202005,469297,1271656,352975,1057642,63801,210171,162941,469909,226742,680080
ES,202006,475162,1285225,357516,1068445,64353,211405,164878,474023,229231,685428
ES,202007,480329,1296525,361546,1077389,64894,212438,166750,477705,231644,690143
ES,202008,486845,1311194,366570,1089093,65438,213490,169253,482971,234691,696461
ES,202009,491871,1322119,370415,1097611,65882,214352,170899,485836,236781,700188
ES,202010,498690,1337093,375090,1108249,66299,215128,172865,489373,239164,704501
ES,202011,481051,1288818,363217,1071358,63611,206289,170373,481985,233984,688274
ES,202012,486260,1300264,366974,1079863,64016,206954,172121,485515,236137,692469
GO,201401,826947,2504555,696426,2287389,208546,744315,287621,941533,496167,1685848
GO,201402,837025,2524147,701813,2298607,209170,744879,287100,936777,496270,1681656
GO,201403,847776,2545891,707936,2312123,210113,746352,286556,931293,496669,1677645
GO,201404,856751,2563621,712143,2321056,210265,745099,285453,925302,495718,1670401
GO,201405,845721,2519333,698557,2272405,201299,705377,303079,985227,504378,1690604
GO,201406,852338,2529813,700767,2275246,201364,704893,301571,977095,502935,1681988
GO,201407,858794,2542637,704163,2282959,202538,708351,301441,974515,503979,1682866
GO,201408,867541,2560531,708801,2293838,203925,712445,301738,972766,505663,1685211
GO,201409,875344,2572426,712744,2299504,205106,714773,301602,968892,506708,1683665
GO,201410,881480,2588215,715444,2308855,205928,718340,301313,967380,507241,1685720
GO,201411,885082,2594684,716580,2311049,206432,719895,300365,962929,506797,1682824
GO,201412,889130,2600822,717802,2312112,206881,720626,298938,956730,505819,1677356
GO,201501,813418,2378337,659394,2125478,176329,622320,274175,874583,450504,1496903
GO,201502,820187,2393350,662936,2134643,177390,625363,273349,870476,450739,1495839
GO,201503,827755,2409297,666429,2143304,178465,628154,271739,863480,450204,1491634
GO,201504,832516,2419188,668945,2149206,179625,631458,270584,858522,450209,1489980
GO,201505,840265,2435353,672868,2158864,180604,634022,269380,852720,449984,1486742
GO,201506,846072,2446117,675023,2162494,180583,632523,265386,836621,445969,1469144
GO,201507,807145,2326641,639207,2045888,167457,584869,249905,785394,417362,1370263
GO,201508,813430,2340334,641666,2052516,168219,586691,247286,775429,415505,1362120
GO,201509,820244,2354095,644707,2059541,169335,589517,245167,767076,414502,1356593
GO,201510,826890,2367720,648094,2067138,170468,592223,243448,759894,413916,1352117
GO,201511,833132,2379846,651093,2073725,171225,593585,242995,757250,414220,1350835
GO,201512,839801,2393225,654006,2080302,172006,595498,242958,755871,414964,1351369
GO,201601,782562,2258494,626696,2007197,162974,567340,222050,708007,385024,1275347
GO,201602,788647,2271547,630063,2015576,163438,568232,223939,712908,387377,1281140
GO,201603,795800,2287282,634592,2026889,164476,570832,225938,717760,390414,1288592
GO,201604,804070,2305697,639818,2039962,165294,572864,228257,723294,393551,1296158
GO,201605,810331,2319449,643756,2049725,165883,574076,229892,727203,395775,1301279
GO,201606,817918,2333889,647392,2057118,170860,594590,246334,783037,417194,1377627
GO,201607,825274,2348611,651239,2065856,170984,593849,246916,782993,417900,1376842
GO,201608,830581,2358940,653713,2070850,166588,572929,228851,718349,395439,1291278
GO,201609,833710,2364257,625979,2003225,166670,571827,228139,714846,394809,1286673
GO,201610,838481,2372762,625729,2001230,166934,571495,225694,705006,392628,1276501
GO,201611,842098,2378276,625519,1999758,167544,572207,223592,697231,391136,1269438
GO,201612,788170,2241214,585778,1883177,159076,543009,207768,651417,366844,1194426
GO,201701,791633,2249067,627504,1983870,162351,559522,226803,715221,389154,1274743
GO,201702,797896,2261767,631185,1991623,162956,560258,228627,719702,391583,1279960
GO,201703,806709,2280065,636918,2004842,164075,562402,230460,723516,394535,1285918
GO,201704,819726,2306226,644857,2022559,165180,563644,232840,728482,398020,1292126
GO,201705,830270,2326924,651137,2036088,165645,563072,233610,728097,399255,1291169
GO,201706,838637,2342437,655894,2045055,166840,564505,231734,719051,398574,1283556
GO,201707,847387,2359493,660778,2055506,167978,566626,231982,717790,399960,1284416
GO,201708,856233,2377057,665702,2066200,169143,568911,232339,716748,401482,1285659
GO,201709,763038,2122993,594327,1848859,151867,509492,215288,669534,367155,1179026
GO,201710,778339,2153741,602023,1867886,153321,512877,217558,674858,370879,1187735
GO,201711,790369,2176116,606838,1879639,153856,513804,219297,679152,373153,1192956
GO,201712,807198,2207121,612903,1894338,154183,513777,221178,683455,375361,1197232
GO,201801,818011,2228489,619083,1910427,154297,513248,221777,684045,376074,1197293
GO,201802,826740,2246854,623700,1921303,154883,513709,224030,689911,378913,1203620
GO,201803,797861,2167734,598962,1846630,146416,483958,216218,667353,362634,1151311
GO,201804,808516,2190660,605801,1862772,147444,486459,218732,672349,366176,1158808
GO,201805,822239,2220671,614630,1884020,148675,489185,222575,681479,371250,1170664
GO,201806,830766,2238553,619897,1896346,149379,490631,223870,683338,373249,1173969
GO,201807,837720,2252069,624223,1905265,152469,501073,228355,696070,380824,1197143
GO,201808,780521,2097186,583307,1778872,144659,474515,222737,679830,367396,1154345
GO,201809,792284,2122464,590546,1796355,145926,477438,223949,680244,369875,1157682
GO,201810,804112,2147572,597708,1813185,144895,472189,222003,669267,366898,1141456
GO,201811,813221,2165334,602054,1823269,145230,472490,222820,669736,368050,1142226
GO,201812,775396,2057046,571407,1728770,136530,444445,215483,647478,352013,1091923
GO,201901,787450,2081754,580307,1752691,138449,451052,221745,666922,360194,1117974
GO,201902,799506,2109051,587436,1770983,139355,453047,224382,673221,363737,1126268
GO,201903,808582,2129770,593257,1785713,140336,455630,225842,675422,366178,1131052
GO,201904,796889,2097064,582372,1753478,135661,440268,222906,667289,358567,1107557
GO,201905,806245,2117210,587877,1766928,136122,441368,225507,672791,361629,1114159
GO,201906,817844,2142193,594630,1784060,137037,443476,228600,680175,365637,1123651
GO,201907,826908,2159437,598951,1793727,137268,443634,229678,681281,366946,1124915
GO,201908,840706,2187697,604580,1807771,137536,443841,231145,683377,368681,1127218
GO,201909,799336,2060458,568774,1693291,128445,413937,225848,667087,354293,1081024
GO,201910,814028,2092452,576241,1712891,129397,416396,228513,673353,357910,1089749
GO,201911,824543,2115658,581698,1727456,129875,417336,231064,680112,360939,1097448
GO,201912,837302,2144473,588313,1745227,130404,418604,233761,687225,364165,1105829
GO,202001,845036,2160934,601784,1775799,130778,419550,234928,690316,365706,1109866
GO,202002,815394,2082925,579711,1713752,126209,404767,233842,687845,360051,1092612
GO,202003,827442,2109594,587658,1731059,127210,407192,235984,693292,363194,1100484
GO,202004,830455,2115002,589663,1734909,127595,407974,236827,694521,364422,1102495
GO,202005,835521,2124658,593810,1743230,128102,408441,239038,699095,367140,1107536
GO,202006,840444,2134284,597612,1751020,128806,409825,240680,702248,369486,1112073
GO,202007,844276,2141214,600511,1756475,129258,410546,241816,704281,371074,1114827
GO,202008,849165,2150483,604232,1763843,129928,411744,243244,706966,373172,1118710
GO,202009,853685,2158359,607450,1769698,130546,412535,244154,708084,374700,1120619
GO,202010,862250,2175146,613081,1781425,131334,413701,245794,711075,377128,1124776
GO,202011,822343,2076929,587453,1707137,125355,395008,240701,697527,366056,1092535
GO,202012,828697,2089803,591893,1716672,126011,396256,242323,700950,368334,1097206
MA,201401,1466172,4670513,1358139,4526424,171588,579298,1045725,3561975,1217313,4141273
MA,201402,1473763,4678264,1362588,4529965,172868,581531,1045563,3554618,1218431,4136149
MA,201403,1483196,4691245,1367915,4537410,173617,581970,1046043,3550204,1219660,4132174
MA,201404,1491941,4703317,1373508,4544967,174306,581934,1046986,3546365,1221292,4128299
MA,201405,1499372,4712770,1377787,4549944,162969,536344,1077042,3637145,1240011,4173489
MA,201406,1509081,4727070,1383413,4558676,163546,537537,1079240,3636914,1242786,4174451
MA,201407,1518782,4742212,1389591,4569409,164186,538673,1082887,3642208,1247073,4180881
MA,201408,1531642,4762262,1397434,4583401,164961,540007,1087890,3650646,1252851,4190653
MA,201409,1538970,4772278,1402326,4590079,166140,542842,1089876,3650519,1256016,4193361
MA,201410,1546235,4788442,1407092,4602711,167252,545908,1091983,3655975,1259235,4201883
MA,201411,1553951,4803145,1412210,4613997,168383,548311,1094557,3661569,1262940,4209880
MA,201412,1560180,4815046,1415995,4622608,169593,551500,1095478,3663004,1265071,4214504
MA,201501,1448255,4498569,1319204,4329811,140311,459338,1038888,3490145,1179199,3949483
MA,201502,1454582,4512010,1323622,4340485,141513,461992,1040183,3493292,1181696,3955284
MA,201503,1460242,4524172,1327913,4350344,142757,464884,1041029,3494071,1183786,3958955
MA,201504,1464593,4533274,1330836,4357332,143691,467415,1041395,3493360,1185086,3960775
MA,201505,1469903,4544109,1334292,4365461,143532,466626,1042938,3495784,1186470,3962410
MA,201506,1473758,4547458,1335570,4364701,144855,472234,1035934,3465026,1180789,3937260
MA,201507,1430903,4428592,1298151,4251513,139590,458337,1004443,3358487,1144033,3816824
MA,201508,1436449,4438514,1300543,4256575,142169,467926,997640,3331329,1139809,3799255
MA,201509,1440484,4443317,1302047,4257512,144389,476451,992360,3308955,1136749,3785406
MA,201510,1444955,4449592,1304085,4260133,146588,484797,988587,3292178,1135175,3776975
MA,201511,1449959,4456358,1306900,4263809,147771,487712,988246,3288266,1136017,3775978
MA,201512,1456984,4469629,1311201,4273106,148247,487977,990306,3293260,1138553,3781237
MA,201601,1425039,4412863,1293909,4240229,144762,480262,969648,3255741,1114410,3736003
MA,201602,1432052,4427394,1299490,4252726,143451,476041,975286,3272155,1118737,3748196
MA,201603,1441824,4448323,1307200,4270760,141757,469603,982914,3293917,1124671,3763520
MA,201604,1453398,4473824,1316351,4292929,140560,465126,990307,3314654,1130867,3779780
MA,201605,1466022,4501976,1327138,4318614,140366,463035,997180,3334126,1137546,3797161
MA,201606,1477086,4522149,1335643,4334900,138668,468041,1019588,3398442,1158256,3866483
MA,201607,1490398,4547629,1346460,4356670,139156,467942,1021366,3398275,1160522,3866217
MA,201608,1499596,4563027,1353072,4368014,142451,465821,1000190,3326506,1142641,3792327
MA,201609,1509368,4579577,1334989,4330945,143155,467034,1002188,3327663,1145343,3794697
MA,201610,1519943,4597376,1338865,4337130,144814,471555,1001476,3319496,1146290,3791051
MA,201611,1527109,4610996,1341376,4342601,146785,476798,999925,3312662,1146710,3789460
MA,201612,1460571,4456165,1287864,4201304,139899,458073,963941,3212079,1103840,3670152
MA,201701,1470690,4476214,1337275,4299164,129930,436844,993844,3302401,1123774,3739245
MA,201702,1478968,4491329,1344145,4312293,129425,433704,998105,3313061,1127530,3746765
MA,201703,1487228,4507685,1350959,4326674,129169,431146,1003875,3328150,1133044,3759296
MA,201704,1497626,4521525,1359026,4337278,128797,426988,1011166,3340699,1139963,3767687
MA,201705,1506949,4535301,1365956,4347639,128885,424941,1015265,3344972,1144150,3769913
MA,201706,1515282,4543548,1371535,4351780,129375,424768,1014790,3331022,1144165,3755790
MA,201707,1524334,4557925,1377904,4362294,130180,425234,1017774,3334243,1147954,3759477
MA,201708,1533619,4572603,1384044,4372469,131317,426594,1019909,3335775,1151226,3762369
MA,201709,1427067,4324092,1298360,4149436,116894,383111,974206,3222024,1091100,3605135
MA,201710,1443840,4353885,1309816,4171935,117740,383709,981812,3236888,1099552,3620597
MA,201711,1459223,4381863,1319493,4192338,118178,383549,988086,3250483,1106264,3634032
MA,201712,1477575,4413492,1328952,4212650,118242,382553,993134,3260270,1111376,3642823
MA,201801,1491832,4436104,1337721,4229263,118601,383752,995653,3258703,1114254,3642455
MA,201802,1502860,4456377,1344806,4243925,118900,383430,999254,3264781,1118154,3648211
MA,201803,1458936,4355500,1309440,4152194,111518,362235,978813,3210308,1090331,3572543
MA,201804,1472288,4380035,1318918,4171120,112066,362615,984736,3222556,1096802,3585171
MA,201805,1489843,4413466,1331913,4198148,112800,362345,993582,3242574,1106382,3604919
MA,201806,1502035,4436210,1340578,4215811,113845,364507,997369,3247993,1111214,3612500
MA,201807,1510878,4448491,1346558,4223907,115587,371406,1003492,3259602,1119079,3631008
MA,201808,1448183,4295925,1299143,4091333,108751,349883,988276,3216167,1097027,3566050
MA,201809,1461731,4315837,1308478,4105187,110851,354678,989481,3209453,1100332,3564131
MA,201810,1481043,4348825,1321302,4128886,114480,362341,988228,3194083,1102708,3556424
MA,201811,1501302,4379249,1334910,4150292,116623,367704,988411,3184399,1105034,3552103
MA,201812,1467439,4272616,1301413,4043871,111629,353248,962393,3101610,1074022,3454858
MA,201901,1489938,4311413,1315882,4075092,109227,346281,971011,3124783,1080238,3471064
MA,201902,1504168,4337064,1324464,4092805,109780,346396,974311,3131501,1084091,3477897
MA,201903,1514658,4354962,1330933,4105116,110622,348806,976099,3130728,1086721,3479534
MA,201904,1497830,4316635,1316217,4068482,107971,340902,966217,3106170,1074188,3447072
MA,201905,1507706,4333732,1322741,4080813,108418,341460,970429,3112778,1078847,3454238
MA,201906,1518710,4353672,1329577,4095058,108876,341630,975104,3122372,1083980,3464002
MA,201907,1527887,4365176,1333650,4099925,109406,342218,976545,3120871,1085951,3463089
MA,201908,1541843,4384988,1339320,4108824,110346,343479,977438,3117101,1087784,3460580
MA,201909,1499895,4266453,1298987,3993492,104569,325375,959362,3065776,1063931,3391151
MA,201910,1515654,4295280,1306865,4011657,105890,328162,962154,3070754,1068044,3398916
MA,201911,1527615,4319127,1313088,4027760,106487,328762,965565,3080353,1072052,3409115
MA,201912,1540090,4343400,1319783,4044098,106977,329078,969097,3088980,1076074,3418058
MA,202001,1547784,4358560,1329186,4064052,107116,328925,970957,3094136,1078073,3423061
MA,202002,1495569,4237817,1284819,3955488,101529,312390,956082,3060764,1057611,3373154
MA,202003,1505066,4257087,1290695,3968429,101949,312734,958357,3067686,1060306,3380420
MA,202004,1508134,4260448,1292574,3970128,102137,312776,959641,3068622,1061778,3381398
MA,202005,1510301,4261114,1294398,3970385,102252,312639,960969,3068483,1063221,3381122
MA,202006,1513977,4266978,1297350,3975239,102765,313403,962270,3070003,1065035,3383406
MA,202007,1519036,4273739,1301008,3979813,104364,318142,960005,3056971,1064369,3375113
MA,202008,1525592,4283371,1305106,3985586,106354,323735,956291,3039560,1062645,3363295
MA,202009,1530698,4286323,1308620,3986244,107677,326681,955952,3030489,1063629,3357170
MA,202010,1537978,4294575,1313707,3991398,109266,329303,957766,3028951,1067032,3358254
MA,202011,1489018,4186366,1276273,3899139,105098,317567,943543,2992728,1048641,3310295
MA,202012,1495385,4196197,1280943,3906590,106106,318988,946416,2997494,1052522,3316482
MG,201401,2753530,8822516,2373721,8122495,661489,2502002,961832,3219056,1623321,5721058
MG,201402,2767250,8838991,2377826,8119534,656989,2480848,961570,3208736,1618559,5689584
MG,201403,2788124,8870990,2385736,8125760,653068,2459363,960194,3192762,1613262,5652125
MG,201404,2807746,8902605,2393315,8134024,650321,2443038,959477,3180518,1609798,5623556
MG,201405,2822838,8926678,2399600,8140656,654831,2441347,1029561,3428128,1684392,5869475
MG,201406,2842966,8956157,2406315,8144473,652855,2428931,1029442,3416805,1682297,5845736
MG,201407,2860139,8984269,2412629,8151310,652080,2422575,1029891,3409707,1681971,5832282
MG,201408,2881192,9016728,2420049,8157093,651020,2414569,1029459,3396354,1680479,5810923
MG,201409,2894576,9013625,2423147,8134595,649174,2397752,1026974,3374050,1676148,5771802
MG,201410,2909368,9054847,2427512,8153875,647720,2395742,1027277,3372321,1674997,5768063
MG,201411,2920742,9069966,2430483,8152080,646486,2388497,1026385,3362437,1672871,5750934
MG,201412,2932654,9086469,2433547,8151052,644975,2380399,1024223,3349794,1669198,5730193
MG,201501,2605341,8011140,2155796,7196716,508376,1899407,921175,2994676,1429551,4894083
MG,201502,2623734,8047702,2162933,7210088,507832,1893570,919894,2985857,1427726,4879427
MG,201503,2645796,8092261,2172511,7228508,507711,1887342,917470,2970657,1425181,4857999
MG,201504,2659727,8118260,2177815,7236794,507362,1882282,914805,2956105,1422167,4838387
MG,201505,2675962,8149971,2184925,7249517,505505,1871387,911804,2938482,1417309,4809869
MG,201506,2689514,8170392,2187654,7245821,501941,1852298,899179,2885328,1401120,4737626
MG,201507,2547302,7710816,2061937,6809948,458819,1682971,850975,2719153,1309794,4402124
MG,201508,2567712,7755997,2070520,6829044,458204,1675485,844299,2690540,1302503,4366025
MG,201509,2583153,7787854,2077152,6842227,458618,1672819,839579,2670201,1298197,4343020
MG,201510,2596930,7814836,2083283,6853489,459194,1672253,836617,2655711,1295811,4327964
MG,201511,2608779,7836937,2088718,6862824,459097,1668969,836615,2652147,1295712,4321116
MG,201512,2622362,7861767,2094039,6870974,458358,1663685,838637,2653762,1296995,4317447
MG,201601,2470597,7487420,2022964,6680134,432257,1576868,786963,2533699,1219220,4110567
MG,201602,2483691,7514913,2030247,6696028,431414,1572957,793408,2550057,1224822,4123014
MG,201603,2504139,7558711,2042833,6724705,430151,1565199,803095,2575362,1233246,4140561
MG,201604,2526161,7608061,2057191,6759280,428814,1557981,814079,2604232,1242893,4162213
MG,201605,2542880,7646255,2068304,6786783,428192,1553374,822079,2626314,1250271,4179688
MG,201606,2561100,7681810,2076628,6802445,452968,1661366,865064,2774690,1318032,4436056
MG,201607,2580056,7722068,2086087,6822498,451187,1650075,868226,2777744,1319413,4427819
MG,201608,2595353,7751687,2091637,6830666,424851,1527608,823387,2610245,1248238,4137853
MG,201609,2608635,7778452,2010603,6614097,424935,1524260,824352,2607305,1249287,4131565
MG,201610,2623393,7805643,2010472,6606261,424635,1518415,820634,2585148,1245269,4103563
MG,201611,2633993,7825428,2009529,6599921,425334,1517034,817160,2569058,1242494,4086092
MG,201612,2451519,7331872,1867794,6168411,395372,1410417,774073,2440205,1169445,3850622
MG,201701,2463370,7356940,1996374,6504589,407889,1479084,827594,2619380,1235483,4098464
MG,201702,2481625,7395598,2008568,6531487,407551,1474058,836927,2643865,1244478,4117923
MG,201703,2501909,7438838,2022635,6563239,408048,1471834,846666,2668158,1254714,4139992
MG,201704,2530444,7496197,2041815,6603590,408317,1466780,858530,2694538,1266847,4161318
MG,201705,2553275,7542068,2056631,6633995,408108,1460947,864677,2702518,1272785,4163465
MG,201706,2573826,7577840,2068262,6652226,407082,1450535,862259,2678908,1269341,4129443
MG,201707,2599031,7627676,2080674,6677141,407366,1446677,866800,2684336,1274166,4131013
MG,201708,2622011,7671501,2091383,6697661,407214,1442057,871285,2690949,1278499,4133006
MG,201709,2361616,6914911,1886143,6047659,358256,1268341,828524,2570988,1186780,3839329
MG,201710,2411833,7016648,1910111,6103733,359570,1269066,841842,2601412,1201412,3870478
MG,201711,2456515,7103193,1928503,6146662,359792,1266957,852493,2626103,1212285,3893060
MG,201712,2501280,7188750,1943886,6181966,359360,1263243,860180,2641218,1219540,3904461
MG,201801,2533118,7251259,1963568,6229105,358722,1258358,863771,2641924,1222493,3900282
MG,201802,2557003,7301825,1976655,6257772,358556,1255394,870685,2654389,1229241,3909783
MG,201803,2469311,7039210,1902588,6013186,332687,1160886,853550,2596882,1186237,3757768
MG,201804,2500680,7108021,1922220,6059468,333633,1160987,865108,2623487,1198741,3784474
MG,201805,2540872,7195956,1946192,6116860,333167,1156221,881084,2662323,1214251,3818544
MG,201806,2566375,7247793,1959794,6147126,333487,1155196,885300,2666844,1218787,3822040
MG,201807,2587911,7287651,1971542,6168623,342798,1191364,895848,2691707,1238646,3883071
MG,201808,2423243,6806619,1851556,5777086,323226,1121313,884827,2655984,1208053,3777297
MG,201809,2460611,6883883,1871962,5822772,324890,1123064,889518,2656629,1214408,3779693
MG,201810,2506952,6981615,1897555,5882421,320944,1101421,889185,2635930,1210129,3737351
MG,201811,2538508,7038901,1911157,5908050,321301,1099936,892001,2631770,1213302,3731706
MG,201812,2457946,6785762,1837556,5672743,299510,1026325,873162,2575850,1172672,3602175
MG,201901,2494250,6864102,1866181,5751140,302966,1040452,891963,2633529,1194929,3673981
MG,201902,2527041,6937046,1885729,5797602,303837,1039899,901422,2653923,1205259,3693822
MG,201903,2552994,6992595,1902320,5834668,304988,1042311,907334,2659932,1212322,3702243
MG,201904,2516948,6895421,1872488,5742829,294213,1004796,899192,2636471,1193405,3641267
MG,201905,2547057,6959380,1891278,5785134,295191,1005707,909060,2654798,1204251,3660505
MG,201906,2577670,7024944,1910083,5828864,296420,1007289,919148,2676135,1215568,3683424
MG,201907,2604463,7078525,1925279,5861829,297555,1008807,925316,2685386,1222871,3694193
MG,201908,2637790,7144874,1939894,5891664,297930,1007158,930497,2689391,1228427,3696549
MG,201909,2520874,6774499,1841673,5563177,276669,933123,913628,2636245,1190297,3569368
MG,201910,2566664,6880720,1869022,5633138,278753,937638,923783,2657378,1202536,3595016
MG,201911,2599675,6958059,1889373,5685623,279673,939319,933813,2681030,1213486,3620349
MG,201912,2631830,7031984,1908300,5733784,280537,940458,942851,2702390,1223388,3642848
MG,202001,2650076,7072346,1942133,5814344,281156,941486,947751,2713979,1228907,3655465
MG,202002,2558602,6815783,1878096,5624102,270227,903716,942321,2700901,1212548,3604617
MG,202003,2588646,6883410,1900407,5670194,271607,906507,950586,2720089,1222193,3626596
MG,202004,2601857,6908787,1910262,5689859,272590,908022,956231,2730443,1228821,3638465
MG,202005,2627381,6960400,1932528,5736478,274781,911797,967869,2751323,1242650,3663120
MG,202006,2651117,7011639,1952520,5780865,276966,916122,977291,2769149,1254257,3685271
MG,202007,2670193,7050953,1968018,5813642,278700,919325,984684,2782531,1263384,3701856
MG,202008,2692470,7096359,1985312,5850349,280451,922322,993516,2799068,1273967,3721390
MG,202009,2710649,7130361,1998985,5876127,281524,922697,999737,2807578,1281261,3730275
MG,202010,2732608,7172140,2014990,5907259,282638,923276,1007630,2820069,1290268,3743345
MG,202011,2635747,6919531,1954845,5725074,270967,884796,994548,2785465,1265515,3670261
MG,202012,2658555,6967540,1972281,5762572,271536,883789,1006367,2812013,1277903,3695802
MS,201401,381462,1117610,298793,974687,78785,281623,116504,383869,195289,665492
MS,201402,387076,1129103,301192,979760,78691,280733,116676,382870,195367,663603
MS,201403,394072,1143372,304119,986405,78639,279913,116614,380971,195253,660884
MS,201404,398979,1152745,306310,990677,78461,278470,116753,379830,195214,658300
MS,201405,402547,1159434,307694,993353,80252,281351,125511,409021,205763,690372
MS,201406,407815,1169424,309694,997422,80264,280891,125787,408504,206051,689395
MS,201407,412621,1179184,311580,1001627,80366,281003,126174,408519,206540,689522
MS,201408,418161,1190597,313936,1007046,80756,281890,126575,408332,207331,690222
MS,201409,421591,1193876,315265,1006685,80842,280934,126553,406416,207395,687350
MS,201410,425798,1206745,317069,1014746,81117,282849,126840,407656,207957,690505
MS,201411,428800,1212733,318240,1017281,81240,283029,126898,407286,208138,690315
MS,201412,432559,1220431,319920,1020921,81350,283166,126739,406055,208089,689221
MS,201501,406980,1141127,301565,959607,70193,245970,117795,376679,187988,622649
MS,201502,411259,1150108,302736,962327,70070,245321,117364,374725,187434,620046
MS,201503,415925,1160742,304580,967219,70265,245751,116731,371494,186996,617245
MS,201504,420019,1169523,306232,971180,70326,245636,116156,368579,186482,614215
MS,201505,423916,1177465,307696,974252,70297,244878,115917,366874,186214,611752
MS,201506,427042,1183803,308233,975320,69912,243151,114491,361570,184403,604721
MS,201507,415035,1148789,296406,938799,65854,229120,109083,343886,174937,573006
MS,201508,418863,1157512,297666,942363,65918,229059,108342,340854,174260,569913
MS,201509,422231,1164230,298442,943978,66037,229249,107745,338099,173782,567348
MS,201510,425133,1169962,299453,946096,66324,229963,107373,336277,173697,566240
MS,201511,428085,1175622,300443,948059,66528,230295,107405,335987,173933,566282
MS,201512,431407,1182527,301365,950013,66712,230627,107500,335993,174212,566620
MS,201601,415008,1147797,300140,949973,64192,223205,100023,320528,164215,543733
MS,201602,418042,1154344,301403,952947,64314,223284,100710,322285,165024,545569
MS,201603,421885,1162727,303186,957271,64289,222877,101628,324370,165917,547247
MS,201604,426040,1171998,305347,962711,64474,223290,102312,325353,166786,548643
MS,201605,428888,1178093,306782,966221,64464,222843,102928,326749,167392,549592
MS,201606,431860,1184328,307972,968939,68511,237883,109401,349254,177912,587137
MS,201607,435712,1192733,309567,973031,68475,237211,109698,349564,178173,586775
MS,201608,438600,1198745,310079,974190,64390,221191,102924,324941,167314,546132
MS,201609,441065,1204021,293055,932035,64445,220999,103023,324775,167468,545774
MS,201610,443779,1209408,293015,931583,64497,220802,102493,322236,166990,543038
MS,201611,445732,1213534,292475,930497,64489,220667,101822,319875,166311,540542
MS,201612,413517,1136264,269444,866205,59911,206309,94716,300629,154627,506938
MS,201701,415647,1141314,295237,930949,62814,217948,101847,325242,164661,543190
MS,201702,419475,1149546,296890,934646,62777,217270,102682,327209,165459,544479
MS,201703,423216,1157532,298720,938813,62938,217243,103380,328545,166318,545788
MS,201704,427353,1165946,300718,942886,63140,217205,104041,329287,167181,546492
MS,201705,431393,1174088,302755,947204,63225,216714,104664,329837,167889,546551
MS,201706,435254,1181394,304607,950661,63441,216623,104267,326800,167708,543423
MS,201707,439322,1189001,306352,953950,63752,217065,104371,325714,168123,542779
MS,201708,442883,1195947,307932,957199,64225,218140,104394,324707,168619,542847
MS,201709,382002,1039490,267023,837196,56176,191829,95726,302553,151902,494382
MS,201710,387601,1050731,269391,842908,56522,192712,96727,304762,153249,497474
MS,201711,393454,1062445,271580,848296,56739,193286,97708,307031,154447,500317
MS,201712,401418,1076803,273486,852744,56770,193063,98380,308378,155150,501441
MS,201801,406859,1088398,276517,860885,56885,193145,98691,308493,155576,501638
MS,201802,411691,1099355,278755,866382,57294,194158,99307,309263,156601,503421
MS,201803,390670,1047800,263661,822588,53439,180993,95609,298610,149048,479603
MS,201804,396477,1060310,266761,830053,53938,182096,97069,301822,151007,483918
MS,201805,405359,1078603,271381,841003,54486,183251,99428,307326,153914,490577
MS,201806,413185,1093257,275078,848947,54907,184139,100898,309971,155805,494110
MS,201807,420097,1105939,278140,855345,56719,189977,103445,316859,160164,506836
MS,201808,388143,1021750,257828,793095,53502,179415,101392,311060,154894,490475
MS,201809,393926,1033589,260839,800122,54106,180984,102045,311463,156151,492447
MS,201810,400954,1047878,264286,808155,53515,178582,101820,307945,155335,486527
MS,201811,407818,1062222,267135,815097,53710,178806,102489,308757,156199,487563
MS,201812,388699,1009512,254272,775688,50551,168435,99906,301418,150457,469853
MS,201901,393419,1019538,258582,787584,51525,171637,102438,309540,153963,481177
MS,201902,399030,1032584,261431,795064,51958,172646,103345,311723,155303,484369
MS,201903,404303,1044007,264098,801610,52326,173659,103968,312122,156294,485781
MS,201904,399388,1030901,259739,788568,51038,169145,102246,307012,153284,476157
MS,201905,406100,1044881,263045,796542,51505,170305,103131,308207,154636,478512
MS,201906,411768,1057095,266090,803999,51970,171363,104259,310578,156229,481941
MS,201907,416634,1066535,268205,808804,52251,171906,104801,311483,157052,483389
MS,201908,423681,1080466,270935,815129,52386,171775,105657,312743,158043,484518
MS,201909,400569,1013327,254340,762617,49086,160904,102920,304877,152006,465781
MS,201910,406848,1026833,257392,770247,49440,161746,103955,307133,153395,468879
MS,201911,413416,1042009,261016,779735,49797,162512,105270,310145,155067,472657
MS,201912,419387,1056046,263866,787343,50020,163071,106210,312126,156230,475197
MS,202001,422662,1063741,271531,805463,50155,163400,106623,313113,156778,476513
MS,202002,406617,1024143,261561,779290,48353,157488,105509,311052,153862,468540
MS,202003,412952,1038657,265719,788116,48731,158416,106613,313366,155344,471782
MS,202004,415051,1042810,267100,790960,48985,158915,107211,314498,156196,473413
MS,202005,420379,1053184,271294,799713,49627,160284,109068,318075,158695,478359
MS,202006,425652,1063596,275288,808106,50118,161195,110861,321537,160979,482732
MS,202007,429500,1070921,278051,813605,50472,161942,112160,323796,162632,485738
MS,202008,432966,1077455,280607,818600,50761,162399,113479,326162,164240,488561
MS,202009,435386,1081572,282275,821600,50988,162632,114207,327119,165195,489751
MS,202010,438853,1087764,284591,825976,51195,162803,115426,329211,166621,492014
MS,202011,418331,1038420,273447,794315,48997,156010,112980,323209,161977,479219
MS,202012,422601,1047781,276007,800406,49223,156413,113952,325192,163175,481605
MT,201401,458456,1376713,378826,1247698,111349,401784,150856,497800,262205,899584
MT,201402,464494,1388371,381692,1253699,111826,402633,150569,495078,262395,897711
MT,201403,470395,1399822,384195,1258701,111531,400344,150492,493098,262023,893442
MT,201404,474824,1408628,386289,1263156,111368,399044,150299,490987,261667,890031
MT,201405,478866,1415796,388003,1266144,111240,393712,163406,535313,274646,929025
MT,201406,484881,1427558,390689,1271895,111692,394566,163399,533525,275091,928091
MT,201407,489444,1436126,392731,1275865,111912,394634,163732,533134,275644,927768
MT,201408,495027,1446994,395131,1281083,112385,395724,163820,531815,276205,927539
MT,201409,498828,1451573,396594,1281491,112632,395367,163623,529241,276255,924608
MT,201410,503403,1464192,398457,1288723,112889,396787,163514,529043,276403,925830
MT,201411,507154,1471451,399845,1291768,112993,396805,163315,527661,276308,924466
MT,201412,511311,1479062,401265,1294829,113092,397016,162811,525400,275903,922416
MT,201501,470633,1351404,369448,1186950,96166,339307,149368,480090,245534,819397
MT,201502,474831,1360178,371179,1191202,96419,340015,148996,478262,245415,818277
MT,201503,479439,1370185,373109,1196140,97018,341435,147966,474187,244984,815622
MT,201504,483055,1377674,374545,1199583,97505,342526,146950,470284,244455,812810
MT,201505,486794,1385197,376007,1202983,97663,342311,146221,467175,243884,809486
MT,201506,489532,1390803,376720,1204394,97650,341740,144114,459518,241764,801258
MT,201507,474695,1344011,362065,1156373,92614,323006,136861,435572,229475,758578
MT,201508,478465,1352335,363098,1159322,92819,323317,134979,428728,227798,752045
MT,201509,486545,1366762,364801,1163189,92925,323216,133519,423008,226444,746224
MT,201510,492232,1377434,366252,1166522,93328,324114,132450,418838,225778,742952
MT,201511,495336,1383379,367243,1168528,93396,323939,131938,416832,225334,740771
MT,201512,499108,1391572,368248,1171105,93520,324250,131376,414621,224896,738871
MT,201601,469076,1321318,356502,1138857,87875,306726,119709,387233,207584,693959
MT,201602,472614,1328881,357858,1142400,88147,307315,119874,387610,208021,694925
MT,201603,476539,1337843,359732,1147438,88425,308074,120275,388380,208700,696454
MT,201604,481244,1347889,361889,1152900,88636,308213,120814,389554,209450,697767
MT,201605,484861,1355728,363665,1157364,88753,308254,121418,390787,210171,699041
MT,201606,488775,1363959,364945,1160237,92392,321895,129205,418897,221597,740792
MT,201607,493402,1373462,366729,1164277,92468,321393,128924,416741,221392,738134
MT,201608,497054,1380218,367497,1165583,88690,306041,119750,382882,208440,688923
MT,201609,499968,1385973,348759,1119830,88732,305563,119584,381727,208316,687290
MT,201610,503327,1392216,348801,1119209,88649,304584,119007,378865,207656,683449
MT,201611,506188,1397460,348683,1118808,88753,304453,118306,376262,207059,680715
MT,201612,472683,1314918,322698,1045487,82639,284715,109365,351531,192004,636246
MT,201701,475153,1320026,351115,1115175,85643,296878,118875,384578,204518,681456
MT,201702,479180,1328305,353335,1120145,86002,297485,120140,387816,206142,685301
MT,201703,483783,1338083,356188,1126786,86567,298781,121444,390742,208011,689523
MT,201704,489839,1350180,359669,1134238,87112,299595,122779,393227,209891,692822
MT,201705,494642,1359803,362469,1140197,87399,299627,123810,395182,211209,694809
MT,201706,499572,1368875,365057,1145017,87860,300134,123829,393050,211689,693184
MT,201707,505330,1380397,368036,1151392,88631,301758,124382,393323,213013,695081
MT,201708,511493,1392369,370881,1157616,89439,303695,124859,393526,214298,697221
MT,201709,448371,1223643,323304,1015775,78536,267437,113325,361394,191861,628831
MT,201710,457264,1241324,327582,1025866,79198,268701,114950,365056,194148,633757
MT,201711,464999,1255670,330452,1032666,79605,269715,116071,367576,195676,637291
MT,201712,474308,1272114,333507,1039604,79829,269762,117069,369705,196898,639467
MT,201801,479978,1282700,337192,1048481,80157,270371,117507,369730,197664,640101
MT,201802,486823,1296782,340348,1055711,80668,271464,118160,370374,198828,641838
MT,201803,463966,1239746,322799,1004979,75634,254536,113367,356254,189001,610790
MT,201804,470902,1254681,326529,1014049,76142,255981,114734,358754,190876,614735
MT,201805,482181,1277737,332244,1028084,76860,257434,117007,364783,193867,622217
MT,201806,491326,1294150,336191,1036549,77186,257842,118102,366695,195288,624537
MT,201807,498644,1306726,339549,1042914,79070,263436,121042,374759,200112,638195
MT,201808,468481,1220481,317714,973381,75213,250121,118912,368251,194125,618372
MT,201809,476296,1236359,321866,982896,75789,251441,120026,369644,195815,621085
MT,201810,486130,1256025,326779,994270,75789,250259,118779,363037,194568,613296
MT,201811,495611,1272621,330285,1001271,76214,250782,119002,361914,195216,612696
MT,201812,473854,1211912,314408,951814,71729,235738,115323,351261,187052,586999
MT,201901,479947,1223923,319723,965981,71837,236824,119757,364446,191594,601270
MT,201902,486990,1239164,323394,974868,72154,237469,120929,366564,193083,604033
MT,201903,494106,1254469,327042,983937,72596,238589,121490,366605,194086,605194
MT,201904,486287,1234355,320678,964970,70223,230388,119466,361055,189689,591443
MT,201905,493294,1248943,324558,974091,70727,231594,120759,363195,191486,594789
MT,201906,501490,1265690,328599,984104,71195,232689,122104,365832,193299,598521
MT,201907,507985,1278174,331554,990928,71611,233765,122896,366864,194507,600629
MT,201908,516626,1295032,335362,999846,71986,234372,123828,367884,195814,602256
MT,201909,491581,1220458,315781,937611,67520,219667,120603,358537,188123,578204
MT,201910,500154,1238321,320064,948202,68071,220952,121939,361403,190010,582355
MT,201911,506660,1251877,323313,956331,68531,222056,123125,364210,191656,586266
MT,201912,512928,1265305,326412,964424,69052,223382,124022,366293,193074,589675
MT,202001,516545,1272536,336761,986848,69272,223873,124649,367865,193921,591738
MT,202002,494307,1218191,322797,949260,66993,216113,123586,365472,190579,581585
MT,202003,502076,1234430,327923,959294,67586,217383,124896,368611,192482,585994
MT,202004,506258,1242401,331061,965583,68240,218605,126218,371275,194458,589880
MT,202005,512674,1255281,336525,977212,69295,220776,128380,375688,197675,596464
MT,202006,517119,1263975,339894,984172,69963,222164,129448,377728,199411,599892
MT,202007,519891,1269268,341931,988316,70412,223118,130195,379149,200607,602267
MT,202008,525508,1279378,345250,995111,71016,224215,131103,381014,202119,605229
MT,202009,529242,1286144,347611,999823,71447,225023,131834,382102,203281,607125
MT,202010,533995,1294955,350432,1005681,71882,225774,132662,383419,204544,609193
MT,202011,510287,1237805,336769,966634,69184,217080,129840,376589,199024,593669
MT,202012,515370,1248043,339712,973222,69781,218443,130672,378184,200453,596627
PA,201401,1297105,4446670,1214729,4328668,206981,742636,860909,3150621,1067890,3893257
PA,201402,1308520,4467703,1223602,4345798,208060,745365,865482,3156261,1073542,3901626
PA,201403,1323078,4495966,1234720,4368539,210411,751202,869043,3157903,1079454,3909105
PA,201404,1333858,4516623,1242516,4384433,211635,753518,871082,3157602,1082717,3911120
PA,201405,1343717,4535153,1249407,4398297,196926,693852,909665,3283218,1106591,3977070
PA,201406,1356766,4561244,1258819,4418736,199243,700475,912763,3285440,1112006,3985915
PA,201407,1367053,4582413,1266679,4436196,200965,705750,916321,3290680,1117286,3996430
PA,201408,1379653,4609076,1276407,4458364,202671,710564,921508,3300088,1124179,4010652
PA,201409,1389162,4622614,1283237,4468061,204454,714727,924349,3300773,1128803,4015500
PA,201410,1400232,4649121,1290804,4489074,206218,720572,927494,3308090,1133712,4028662
PA,201411,1410067,4668196,1297449,4503477,207365,723322,930781,3314548,1138146,4037870
PA,201412,1420031,4687663,1303352,4516381,209185,728417,931677,3313394,1140862,4041811
PA,201501,1333276,4429160,1229985,4279887,186013,654967,886505,3162960,1072518,3817927
PA,201502,1342182,4448422,1235999,4294484,187270,658008,888747,3167612,1076017,3825620
PA,201503,1351761,4469363,1242426,4310268,188774,661451,890371,3170076,1079145,3831527
PA,201504,1360445,4488057,1248432,4324729,190499,665980,891658,3171062,1082157,3837042
PA,201505,1370463,4509452,1255125,4340853,191772,669038,892555,3170186,1084327,3839224
PA,201506,1377174,4521865,1258773,4348009,194047,677572,885993,3141010,1080040,3818582
PA,201507,1344827,4425320,1229522,4253459,189588,666172,858356,3041503,1047944,3707675
PA,201508,1353608,4445008,1234737,4266963,193059,678303,852524,3017455,1045583,3695758
PA,201509,1361703,4461737,1239905,4279012,196222,688336,849230,3003083,1045452,3691419
PA,201510,1368491,4475110,1244026,4288198,199173,698141,845948,2988668,1045121,3686809
PA,201511,1376705,4491105,1249426,4299860,201150,703917,845831,2984700,1046981,3688617
PA,201512,1388542,4515564,1257066,4317630,202957,708474,847648,2987156,1050605,3695630
PA,201601,1353360,4436414,1236748,4267180,197255,693554,825773,2935892,1023028,3629446
PA,201602,1360384,4452065,1241974,4280073,197164,692607,830102,2947690,1027266,3640297
PA,201603,1370629,4474106,1249675,4298399,196978,690108,836209,2964830,1033187,3654938
PA,201604,1382888,4500185,1259160,4320383,196383,685763,844331,2986729,1040714,3672492
PA,201605,1393644,4523759,1267686,4340703,196232,683313,851359,3005613,1047591,3688926
PA,201606,1402578,4539712,1273694,4352103,193506,677894,879967,3102127,1073473,3780021
PA,201607,1413584,4562233,1281486,4369444,193968,677422,883247,3107489,1077215,3784911
PA,201608,1422406,4578952,1287062,4380992,198513,685098,857577,3011587,1056090,3696685
PA,201609,1431495,4597450,1272932,4350318,199486,685873,860229,3016692,1059715,3702565
PA,201610,1440428,4615163,1277098,4359014,201342,690208,859502,3009646,1060844,3699854
PA,201611,1446272,4627160,1279657,4364707,203674,696166,857427,3000900,1061101,3697066
PA,201612,1395281,4491193,1235334,4235468,197103,675142,829594,2916336,1026697,3591478
PA,201701,1402546,4505573,1270783,4313922,190630,658504,860570,3020676,1051200,3679180
PA,201702,1411910,4523099,1278172,4328562,191378,658746,864499,3029884,1055877,3688630
PA,201703,1422442,4542952,1286195,4344694,192201,658915,869578,3042124,1061779,3701039
PA,201704,1437750,4571374,1297753,4367716,193660,659247,876532,3057945,1070192,3717192
PA,201705,1450906,4595858,1307809,4387472,195017,659854,881571,3067774,1076588,3727628
PA,201706,1463950,4616907,1316986,4402686,197597,664383,881495,3058097,1079092,3722480
PA,201707,1477710,4641942,1326387,4421126,200404,669973,882696,3056781,1083100,3726754
PA,201708,1488183,4661700,1333926,4436290,204055,678325,882321,3052358,1086376,3730683
PA,201709,1398708,4413561,1257778,4207923,187654,621420,848345,2954976,1035999,3576396
PA,201710,1420824,4458182,1272981,4242532,189786,625368,856641,2974365,1046427,3599733
PA,201711,1439151,4493810,1284438,4268734,190642,626128,863405,2990541,1054047,3616669
PA,201712,1462972,4537115,1296128,4295314,191084,625982,869177,3002194,1060261,3628176
PA,201801,1479090,4563599,1304519,4312220,191668,627411,870069,2997313,1061737,3624724
PA,201802,1492300,4588126,1312692,4329104,192386,627930,874212,3004440,1066598,3632370
PA,201803,1456086,4487036,1279090,4229778,183354,598202,858063,2954997,1041417,3553199
PA,201804,1474037,4522962,1292136,4258201,184748,600053,866448,2973642,1051196,3573695
PA,201805,1496951,4568052,1309004,4294054,186468,602022,877575,2998449,1064043,3600471
PA,201806,1512809,4598319,1320445,4317319,188011,605378,883478,3007825,1071489,3613203
PA,201807,1523689,4617780,1328218,4331819,190153,611980,893145,3033916,1083298,3645896
PA,201808,1469354,4473864,1286934,4206855,182367,586573,881886,2999130,1064253,3585703
PA,201809,1486653,4505009,1299807,4231247,185189,592703,885285,3000173,1070474,3592876
PA,201810,1513149,4555526,1320038,4272316,189468,602217,886128,2987146,1075596,3589363
PA,201811,1533125,4591999,1334418,4300378,192055,607903,890730,2992623,1082785,3600526
PA,201812,1504898,4497122,1309619,4211141,185268,584298,878912,2951006,1064180,3535304
PA,201901,1534741,4550459,1333942,4260383,185691,581176,894063,2993884,1079754,3575060
PA,201902,1555611,4590391,1350221,4293254,187430,583216,902820,3013152,1090250,3596368
PA,201903,1569821,4617053,1361075,4314734,189145,587301,907455,3019195,1096600,3606496
PA,201904,1560573,4586678,1353921,4286292,185479,574048,906014,3010760,1091493,3584808
PA,201905,1579339,4621426,1368663,4314919,186912,576137,914793,3027553,1101705,3603690
PA,201906,1598617,4658746,1383376,4345446,188480,578643,923264,3045302,1111744,3623945
PA,201907,1613631,4683689,1393071,4363023,189625,580099,926976,3049704,1116601,3629803
PA,201908,1629899,4711264,1401763,4379812,191169,583238,928268,3047960,1119437,3631198
PA,201909,1586345,4577770,1361794,4253994,182300,554455,914929,3004863,1097229,3559318
PA,201910,1609630,4624849,1376442,4288261,184334,558610,921476,3018938,1105810,3577548
PA,201911,1625318,4658221,1386503,4313345,185057,559382,926886,3032870,1111943,3592252
PA,201912,1641310,4692017,1396784,4338672,185864,560172,932250,3046387,1118114,3606559
PA,202001,1651055,4712233,1410863,4368320,186345,560829,934868,3052703,1121213,3613532
PA,202002,1615469,4618958,1381592,4287400,180421,541657,927977,3034582,1108398,3576239
PA,202003,1628782,4647289,1390864,4307953,181275,542519,931589,3044499,1112864,3587018
PA,202004,1636084,4660478,1396092,4317861,182029,543549,934386,3049437,1116415,3592986
PA,202005,1639706,4665491,1399194,4322125,182445,543913,936176,3051593,1118621,3595506
PA,202006,1644339,4672900,1402952,4328293,183163,545048,937622,3053160,1120785,3598208
PA,202007,1651171,4683714,1408217,4336786,184154,546372,939815,3055918,1123969,3602290
PA,202008,1660390,4698990,1415367,4349018,185515,548637,942893,3060317,1128408,3608954
PA,202009,1668067,4708529,1421044,4355551,186854,550761,944704,3059137,1131558,3609898
PA,202010,1677927,4722654,1427755,4365027,188741,554238,946434,3058188,1135175,3612426
PA,202011,1631474,4609578,1392720,4269245,182409,535923,932368,3019953,1114777,3555876
PA,202012,1641249,4625356,1399937,4281276,184398,539840,935157,3022912,1119555,3562752
PB,201401,834671,2536330,774752,2446159,112285,395178,544496,1714118,656781,2109296
PB,201402,839442,2543480,777777,2450548,111792,392508,546458,1716617,658250,2109125
PB,201403,844024,2549996,780500,2454159,111224,389276,547650,1716814,658874,2106090
PB,201404,847339,2554720,782363,2456425,110811,386929,548094,1715275,658905,2102204
PB,201405,851067,2560612,784662,2459953,107954,371587,564018,1766427,671972,2138014
PB,201406,856139,2568632,787346,2464001,107696,370207,565416,1767473,673112,2137680
PB,201407,860098,2575627,789699,2468286,107469,368948,567014,1770163,674483,2139111
PB,201408,866521,2586297,793723,2474866,107284,367524,569806,1774256,677090,2141780
PB,201409,870455,2589838,796036,2475832,107171,366018,571249,1774601,678420,2140619
PB,201410,874047,2597959,798095,2481455,107002,365422,572920,1778824,679922,2144246
PB,201411,877106,2603126,799705,2484292,106724,364064,574293,1781706,681017,2145770
PB,201412,880270,2608969,801344,2487495,106667,363345,575359,1783972,682026,2147317
PB,201501,797974,2390061,731042,2288994,83389,291176,542646,1691438,626035,1982614
PB,201502,802001,2397940,733419,2294148,83538,290738,543738,1693476,627276,1984214
PB,201503,806013,2405443,735876,2299109,83939,290792,544313,1693535,628252,1984327
PB,201504,809068,2411318,737706,2303031,84165,290575,544555,1693345,628720,1983920
PB,201505,811942,2416184,739382,2305789,83635,288135,544889,1692186,628524,1980321
PB,201506,814196,2416753,739942,2303317,84128,289200,539158,1668034,623286,1957234
PB,201507,785339,2340284,717229,2233837,79919,274807,523036,1614149,602955,1888956
PB,201508,788960,2345879,718716,2235760,80325,274986,520937,1604913,601262,1879899
PB,201509,791854,2350345,720120,2237787,80871,276173,519889,1599933,600760,1876106
PB,201510,794331,2353525,721286,2238801,81471,277830,519595,1597233,601066,1875063
PB,201511,799203,2360110,722769,2240207,81379,276943,519790,1596177,601169,1873120
PB,201512,802672,2365650,724625,2243030,80865,274370,521390,1599555,602255,1873925
PB,201601,782139,2325276,712745,2219359,77728,265899,510221,1578611,587949,1844510
PB,201602,785738,2331693,715221,2223983,76858,262817,513355,1586011,590213,1848828
PB,201603,790364,2340137,718617,2230513,75793,258565,517230,1595482,593023,1854047
PB,201604,795491,2349186,722492,2237575,74726,254473,521495,1604973,596221,1859446
PB,201605,799659,2356853,725513,2243413,74232,252296,524451,1611682,598683,1863978
PB,201606,803648,2360845,727637,2244326,77812,271976,533069,1635095,610881,1907071
PB,201607,807875,2367642,730095,2248190,77299,269059,533923,1634940,611222,1903999
PB,201608,812060,2372602,732172,2249578,74629,249327,523853,1599473,598482,1848800
PB,201609,815293,2376838,720943,2221983,74952,249225,524253,1597804,599205,1847029
PB,201610,818123,2379224,720691,2217993,75631,249965,520852,1583517,596483,1833482
PB,201611,820541,2381899,720014,2214409,76856,252387,517082,1570076,593938,1822463
PB,201612,780377,2279011,685843,2118572,72107,236256,496844,1512478,568951,1748734
PB,201701,783674,2284056,707817,2167073,68681,236506,512279,1554968,580960,1791474
PB,201702,787806,2290226,710807,2171417,67987,233213,515930,1563123,583917,1796336
PB,201703,792416,2297100,714121,2176329,67642,231297,519399,1569872,587041,1801169
PB,201704,798167,2305126,718210,2181788,67060,227958,522946,1575317,590006,1803275
PB,201705,802616,2311262,721267,2185558,66664,225691,524707,1575909,591371,1801600
PB,201706,806934,2314461,723518,2184805,66967,225266,523124,1563290,590091,1788556
PB,201707,811601,2321137,726082,2187749,67087,224420,524178,1563212,591265,1787632
PB,201708,817104,2328973,729277,2191707,67339,223991,525578,1563470,592917,1787461
PB,201709,760067,2181830,681399,2058535,58024,193173,504387,1509859,562411,1703032
PB,201710,769309,2196861,686739,2067900,57551,190959,508976,1518656,566527,1709615
PB,201711,779040,2212886,691308,2076951,57047,189035,512818,1526562,569865,1715597
PB,201712,790890,2231467,695544,2085318,56180,186105,515949,1532140,572129,1718245
PB,201801,799445,2245902,700467,2095484,56143,185782,517566,1532945,573709,1718727
PB,201802,805691,2256950,704413,2102844,56062,185142,519965,1536398,576027,1721540
PB,201803,785074,2201343,686420,2050022,51854,171526,510805,1508617,562659,1680143
PB,201804,793231,2215476,692448,2060936,52126,171753,515219,1516226,567345,1687979
PB,201805,802832,2232197,699441,2073778,52022,170442,520931,1527156,572953,1697598
PB,201806,809013,2242064,703764,2080944,52334,170890,523178,1528986,575512,1699876
PB,201807,812840,2246135,706443,2083245,54199,179172,525004,1529290,579203,1708462
PB,201808,773635,2139263,677543,1993453,49965,164282,518132,1507165,568097,1671447
PB,201809,781529,2151091,682899,2001563,50801,166424,520055,1505930,570856,1672354
PB,201810,792959,2170718,690235,2015053,51672,166960,521471,1502813,573143,1669773
PB,201811,803163,2186382,695290,2023372,52274,167985,522547,1501238,574821,1669223
PB,201812,788580,2141461,679759,1978306,49390,159148,513009,1474276,562399,1633424
PB,201901,800097,2163739,687591,1997166,48328,156944,517772,1485616,566100,1642560
PB,201902,808121,2178962,692740,2007758,48374,156417,520508,1490236,568882,1646653
PB,201903,813558,2187804,696482,2013983,48632,157162,522095,1490187,570727,1647349
PB,201904,805303,2165789,688722,1991969,46900,151681,517120,1476203,564020,1627884
PB,201905,812517,2178144,693928,2001209,47209,152058,520482,1480997,567691,1633055
PB,201906,819592,2190903,698810,2010579,47332,152068,523774,1486733,571106,1638801
PB,201907,824482,2198606,701373,2014967,47410,152000,524787,1487259,572197,1639259
PB,201908,833438,2213339,705435,2022196,47497,151865,525980,1486516,573477,1638381
PB,201909,812791,2152314,686447,1964911,44605,142987,519097,1466813,563702,1609800
PB,201910,822344,2170105,692063,1976815,44931,143336,522238,1472565,567169,1615901
PB,201911,829559,2184566,696393,1986842,45053,143425,524792,1478182,569845,1621607
PB,201912,836331,2198764,700570,1996834,45151,143524,527211,1483676,572362,1627200
PB,202001,841133,2209219,706825,2011028,45409,144139,528512,1486857,573921,1630996
PB,202002,822618,2164631,692163,1973982,43770,138588,524352,1478478,568122,1617066
PB,202003,829655,2178997,697501,1984125,44146,139206,526600,1483554,570746,1622760
PB,202004,832840,2183881,699935,1987894,44515,139848,527960,1485127,572475,1624975
PB,202005,836271,2189021,702916,1992456,44957,140693,529510,1486586,574467,1627279
PB,202006,837602,2191061,703964,1994058,45096,140958,530026,1486987,575122,1627945
PB,202007,839355,2193739,705341,1996181,45330,141395,530543,1487324,575873,1628719
PB,202008,842156,2198428,707414,1999778,45699,142169,531228,1487844,576927,1630013
PB,202009,845355,2201588,709880,2001906,46126,142743,532196,1486877,578322,1629620
PB,202010,849552,2207738,713157,2006760,46544,143340,534091,1489035,580635,1632375
PB,202011,827711,2157498,698140,1967398,44911,138709,527792,1474497,572703,1613206
PB,202012,831109,2163766,700896,1972669,45264,139248,529389,1477394,574653,1616642
PE,201401,1909464,5567889,1793199,5396201,313164,994664,1198233,3650613,1511397,4645277
PE,201402,1916263,5575474,1797046,5398789,314632,997453,1194634,3632802,1509266,4630255
PE,201403,1923416,5582662,1800642,5400006,315626,998235,1190937,3614110,1506563,4612345
PE,201404,1928683,5586343,1803268,5399210,315547,995702,1188609,3599675,1504156,4595377
PE,201405,1935249,5593522,1807080,5401837,306156,947444,1231843,3730398,1537999,4677842
PE,201406,1944823,5605871,1812916,5408177,306738,947884,1232849,3724430,1539587,4672314
PE,201407,1952930,5618031,1818290,5415592,306773,947164,1235405,3724926,1542178,4672090
PE,201408,1965564,5637404,1827038,5428714,307453,948103,1239859,3727285,1547312,4675388
PE,201409,1973360,5641709,1831780,5428084,308695,949185,1239009,3715255,1547704,4664440
PE,201410,1983555,5664906,1838746,5445726,310184,953713,1240967,3717756,1551151,4671469
PE,201411,1991878,5678729,1843901,5454400,311004,954878,1242230,3717303,1553234,4672181
PE,201412,2003599,5698152,1849988,5464729,311913,956426,1241871,3711715,1553784,4668141
PE,201501,1811175,5207246,1672960,5001767,246881,781261,1158873,3482811,1405754,4264072
PE,201502,1822859,5229423,1679713,5015471,247472,781509,1159689,3482756,1407161,4264265
PE,201503,1833340,5248543,1686442,5028142,249323,784833,1159330,3477830,1408653,4262663
PE,201504,1841824,5264852,1692069,5039727,250907,787850,1159289,3474973,1410196,4262823
PE,201505,1852834,5285665,1698862,5053518,250554,785378,1160220,3473167,1410774,4258545
PE,201506,1861668,5298106,1702621,5056899,251523,787465,1150511,3433850,1402034,4221315
PE,201507,1797160,5130821,1642429,4892692,239220,752982,1104702,3295856,1343922,4048838
PE,201508,1808281,5151731,1647668,4903012,241444,758387,1095696,3262131,1337140,4020518
PE,201509,1815612,5164579,1651168,4909109,243614,763917,1089929,3241709,1333543,4005626
PE,201510,1822615,5176394,1655161,4915892,246033,771080,1085426,3224282,1331459,3995362
PE,201511,1829256,5187098,1659215,4922237,246774,772347,1085270,3220541,1332044,3992888
PE,201512,1837981,5203320,1664694,4932737,247279,771844,1086169,3220291,1333448,3992135
PE,201601,1785785,5099225,1632395,4867446,238287,750547,1055581,3158148,1293868,3908695
PE,201602,1793045,5112780,1637577,4877538,237232,746965,1060870,3170409,1298102,3917374
PE,201603,1803258,5131421,1645482,4892513,235845,741175,1068686,3187660,1304531,3928835
PE,201604,1816036,5154862,1655836,4912105,233595,732939,1079637,3211911,1313232,3944850
PE,201605,1826813,5174243,1664551,4928205,232132,726558,1088674,3231975,1320806,3958533
PE,201606,1836241,5186634,1669911,4933927,231979,742405,1119265,3318215,1351244,4060620
PE,201607,1847881,5205269,1677460,4945774,230938,736531,1122343,3319463,1353281,4055994
PE,201608,1859277,5223030,1684627,4956131,232116,717462,1093007,3223219,1325123,3940681
PE,201609,1868394,5238076,1656861,4891006,233123,717667,1095712,3225532,1328835,3943199
PE,201610,1877557,5250868,1659676,4890588,235133,720031,1093204,3208991,1328337,3929022
PE,201611,1883048,5258923,1660331,4888818,237699,724793,1088398,3191311,1326097,3916104
PE,201612,1792501,5042488,1581619,4684352,224452,686878,1043965,3071626,1268417,3758504
PE,201701,1798477,5051910,1634654,4800559,211907,672098,1086181,3186679,1298088,3858777
PE,201702,1807460,5066268,1641427,4811431,210985,667663,1093003,3200844,1303988,3868507
PE,201703,1817745,5082874,1649605,4824900,210600,664001,1100750,3216894,1311350,3880895
PE,201704,1831264,5103695,1660111,4841149,210242,659622,1109806,3233732,1320048,3893354
PE,201705,1844807,5124523,1670476,4856946,210582,657328,1115299,3238362,1325881,3895690
PE,201706,1858156,5139336,1680086,4865918,211780,656056,1114848,3220040,1326628,3876096
PE,201707,1875000,5166251,1691858,4885088,213172,656288,1120214,3226504,1333386,3882792
PE,201708,1891551,5192173,1703158,4902911,214678,656801,1125191,3232170,1339869,3888971
PE,201709,1763698,4870328,1595812,4612816,192035,587444,1082181,3126152,1274216,3713596
PE,201710,1786957,4910764,1611843,4642528,192779,586611,1093896,3149178,1286675,3735789
PE,201711,1810157,4949272,1623375,4665351,192399,583514,1101922,3165284,1294321,3748798
PE,201712,1844034,5003184,1634327,4688802,191488,579675,1106029,3170701,1297517,3750376
PE,201801,1877716,5054252,1645746,4712359,190652,576581,1105432,3160568,1296084,3737149
PE,201802,1896856,5085629,1655835,4730408,190319,573941,1110858,3167699,1301177,3741640
PE,201803,1859281,4978620,1619643,4623784,178796,537581,1095010,3119110,1273806,3656691
PE,201804,1878148,5012271,1633381,4649359,178675,534823,1105464,3138972,1284139,3673795
PE,201805,1901494,5053264,1650692,4681085,178324,530899,1119292,3165536,1297616,3696435
PE,201806,1915905,5075981,1661105,4697754,178743,530707,1125165,3171419,1303908,3702126
PE,201807,1926344,5089080,1668620,4706088,182209,542530,1132138,3182530,1314347,3725060
PE,201808,1854998,4898142,1612479,4540187,172378,511739,1121082,3148107,1293460,3659846
PE,201809,1874485,4927991,1626517,4561809,174023,514077,1127170,3150065,1301193,3664142
PE,201810,1903766,4977471,1647642,4598979,174979,512769,1133097,3145325,1308076,3658094
PE,201811,1923001,5006638,1658855,4616525,175784,513496,1137404,3145347,1313188,3658843
PE,201812,1885096,4893707,1618523,4504218,165163,483345,1118388,3092646,1283551,3575991
PE,201901,1913630,4947193,1636398,4547446,163172,478226,1130544,3122911,1293716,3601137
PE,201902,1933094,4982563,1649906,4573426,163160,476300,1139892,3140510,1303052,3616810
PE,201903,1947037,5006033,1659862,4590571,163427,476300,1145147,3145364,1308574,3621664
PE,201904,1925147,4953496,1641528,4541367,157469,458472,1137672,3125381,1295141,3583853
PE,201905,1943401,4985411,1655232,4566201,157495,457069,1147827,3142509,1305322,3599578
PE,201906,1961142,5017436,1668502,4591366,157543,455609,1157950,3161720,1315493,3617329
PE,201907,1974515,5038357,1676964,4605239,158047,455888,1162593,3166622,1320640,3622510
PE,201908,1995052,5070096,1687979,4623129,158242,454422,1167646,3170763,1325888,3625185
PE,201909,1940492,4916195,1640002,4482100,148664,426112,1154788,3133790,1303452,3559902
PE,201910,1963878,4959357,1655650,4513537,149743,427329,1163972,3150424,1313715,3577753
PE,201911,1981042,4993393,1667164,4538717,149900,426361,1171525,3166628,1321425,3592989
PE,201912,1998072,5026980,1678376,4563140,150012,425504,1178683,3181971,1328695,3607475
PE,202001,2009316,5049907,1693228,4595750,150192,425376,1182565,3190764,1332757,3616140
PE,202002,1968896,4950166,1659488,4511846,144523,408754,1176368,3178197,1320891,3586951
PE,202003,1984076,4979995,1671991,4534204,145040,408645,1182518,3192028,1327558,3600673
PE,202004,1990575,4989184,1676924,4541263,145374,408831,1186028,3196836,1331402,3605667
PE,202005,1999546,5004146,1684464,4554155,146022,409762,1190726,3203753,1336748,3613515
PE,202006,2005796,5014993,1689681,4563399,146811,410901,1193222,3207515,1340033,3618416
PE,202007,2011437,5023411,1694262,4570367,147463,411721,1195757,3210829,1343220,3622550
PE,202008,2022029,5040186,1702652,4583997,148885,413912,1200329,3217415,1349214,3631327
PE,202009,2031143,5051670,1709708,4592328,150285,415913,1203665,3218700,1353950,3634613
PE,202010,2041917,5067083,1717877,4603989,151343,417021,1208615,3224916,1359958,3641937
PE,202011,1993459,4954791,1683145,4514489,145712,401610,1195947,3195273,1341659,3596883
PE,202012,2002156,4969669,1690195,4526791,146660,402939,1200531,3203384,1347191,3606323
PI,201401,732627,2247308,677897,2163040,87827,308592,501049,1592137,588876,1900729
PI,201402,737044,2253882,680402,2166305,88161,308791,501227,1588904,589388,1897695
PI,201403,741188,2259303,682460,2168046,88125,307616,500725,1583408,588850,1891024
PI,201404,744164,2262977,683929,2169011,87970,306169,500352,1579170,588322,1885339
PI,201405,746813,2266267,685166,2169946,85235,295066,513261,1619172,598496,1914238
PI,201406,750234,2270756,686811,2171461,85264,294840,513812,1617746,599076,1912586
PI,201407,753536,2275508,688729,2174000,85452,295145,514566,1617286,600018,1912431
PI,201408,758241,2282895,691766,2178664,85770,295603,515976,1617702,601746,1913305
PI,201409,761630,2286426,693954,2180100,86039,295463,516770,1616259,602809,1911722
PI,201410,764512,2292872,695803,2184799,86295,296115,517730,1618075,604025,1914190
PI,201411,767120,2296974,697211,2186838,86235,295542,518473,1618580,604708,1914122
PI,201412,769977,2301593,698587,2188887,86357,295519,518818,1618068,605175,1913587
PI,201501,709467,2133226,648885,2038587,68524,236866,493601,1543540,562125,1780406
PI,201502,712752,2139537,650212,2041369,68740,236954,493378,1542251,562118,1779205
PI,201503,715916,2145780,651772,2044706,69157,237547,493226,1540694,562383,1778241
PI,201504,717778,2149548,652949,2047350,69396,238008,493421,1540556,562817,1778564
PI,201505,719885,2153361,653978,2049318,69210,237093,493445,1539366,562655,1776459
PI,201506,721456,2153526,653633,2045967,69264,237344,489506,1523110,558770,1760454
PI,201507,698060,2089345,633583,1985219,65885,226339,474664,1474714,540549,1701053
PI,201508,701200,2094356,634561,1986217,66802,228857,471112,1460842,537914,1689699
PI,201509,703816,2098308,635623,1987486,67539,230807,469262,1453087,536801,1683894
PI,201510,705270,2099787,636000,1987182,67781,231566,468422,1448983,536203,1680549
PI,201511,707158,2101949,636872,1987734,67808,231079,468643,1448391,536451,1679470
PI,201512,709782,2106139,638016,1989395,67641,229719,469020,1448527,536661,1678246
PI,201601,682743,2052340,620856,1954355,64273,220727,454242,1419499,518515,1640226
PI,201602,685963,2058245,623161,1958740,63808,218996,456865,1425524,520673,1644520
PI,201603,690233,2065832,626261,1964426,63226,216266,460393,1433779,523619,1650045
PI,201604,694803,2074111,629624,1970699,62517,213448,464410,1443147,526927,1656595
PI,201605,698507,2081047,632306,1976041,61968,211043,467534,1450830,529502,1661873
PI,201606,701428,2082922,633457,1975010,63912,224969,475367,1470996,539279,1695965
PI,201607,704938,2088153,635177,1977156,63440,222590,475669,1469080,539109,1691670
PI,201608,707806,2091806,636387,1977892,61972,208951,467009,1439414,528981,1648365
PI,201609,710545,2095816,627867,1956018,62360,209412,466644,1436028,529004,1645440
PI,201610,712888,2098895,628010,1954478,63041,210847,464730,1427382,527771,1638229
PI,201611,714809,2101042,627335,1950978,63975,212775,462066,1417493,526041,1630268
PI,201612,676769,2006401,595089,1863551,59034,197062,443179,1366631,502213,1563693
PI,201701,678524,2008703,611519,1901667,56109,196156,454629,1398761,510738,1594917
PI,201702,681397,2013305,613551,1904941,55751,194374,456783,1403450,512534,1597824
PI,201703,684855,2018733,616124,1909002,55584,193176,459416,1408848,515000,1602024
PI,201704,689232,2024795,619324,1913095,55446,191555,462141,1412771,517587,1604326
PI,201705,688687,2019018,618047,1905902,54781,188589,461105,1406585,515886,1595174
PI,201706,692165,2021304,619912,1905497,55107,188884,460535,1398789,515642,1587673
PI,201707,695564,2025637,621639,1907083,55275,188792,461264,1397902,516539,1586694
PI,201708,699868,2032662,623916,1910542,55531,188722,462034,1397678,517565,1586400
PI,201709,648613,1903586,580522,1793207,48465,165031,440447,1346215,488912,1511246
PI,201710,655781,1916466,584841,1801490,48566,164544,443452,1351931,492018,1516475
PI,201711,662578,1928749,588484,1808865,48619,164172,445997,1357025,494616,1521197
PI,201712,670292,1942871,592083,1816409,48668,163886,447871,1359807,496539,1523693
PI,201801,676153,1953244,596161,1824803,48845,164264,448508,1357849,497353,1522113
PI,201802,682583,1965666,600207,1833259,48833,163708,451102,1362596,499935,1526304
PI,201803,664769,1918828,584858,1789270,45348,152194,443362,1341080,488710,1493274
PI,201804,671978,1931755,589598,1798345,45407,151851,447155,1348495,492562,1500346
PI,201805,681347,1948301,595856,1810067,45435,151224,452047,1357601,497482,1508825
PI,201806,687475,1958620,599711,1816744,45573,151385,453822,1358276,499395,1509661
PI,201807,691356,1963154,602122,1818987,46905,157459,455502,1358557,502407,1516016
PI,201808,665492,1894172,582954,1760917,44082,147897,450524,1344149,494606,1492046
PI,201809,671365,1902769,586630,1765984,44432,148535,452121,1343284,496553,1491819
PI,201810,679292,1916403,591994,1775564,43974,145598,454350,1343352,498324,1488950
PI,201811,685080,1925392,595385,1780877,44034,145394,456262,1344908,500296,1490302
PI,201812,670155,1882394,581219,1739824,41277,136673,449162,1326051,490439,1462724
PI,201901,676941,1895998,587516,1754967,41353,137491,452672,1335350,494025,1472841
PI,201902,683161,1908265,591643,1763823,41289,136819,455396,1340676,496685,1477495
PI,201903,688359,1917317,595087,1770083,41422,137269,456853,1340697,498275,1477966
PI,201904,680232,1897320,588344,1751537,39839,132359,453035,1330515,492874,1462874
PI,201905,686675,1909016,592964,1760356,39873,132072,456565,1336794,496438,1468866
PI,201906,693491,1921611,597420,1769278,39894,131714,459873,1343326,499767,1475040
PI,201907,698258,1929178,600151,1773724,39962,131676,461251,1344230,501213,1475906
PI,201908,704004,1938881,602821,1778299,40036,131703,461958,1343137,501994,1474840
PI,201909,686176,1887253,587036,1730729,37668,124292,455671,1325582,493339,1449874
PI,201910,695098,1906549,592292,1743322,37915,124899,458200,1330395,496115,1455294
PI,201911,701317,1920227,596207,1753087,37857,124589,460556,1335943,498413,1460532
PI,201912,707570,1933851,600057,1762598,37880,124412,462735,1341204,500615,1465616
PI,202001,711218,1941995,605400,1775023,37939,124444,463873,1344087,501812,1468531
PI,202002,695266,1903959,593057,1743655,36270,119039,460126,1336878,496396,1455917
PI,202003,700669,1915656,596870,1751661,36304,118878,461906,1341221,498210,1460099
PI,202004,702581,1918089,598250,1753258,36341,118718,462850,1342041,499191,1460759
PI,202005,705415,1921592,600755,1756351,36517,118870,464529,1343480,501046,1462350
PI,202006,708485,1927524,603336,1761518,36760,119249,465727,1345324,502487,1464573
PI,202007,712317,1934536,606618,1767636,37049,119652,467243,1347352,504292,1467004
PI,202008,716541,1941898,610172,1773894,37311,119892,469242,1350097,506553,1469989
PI,202009,719746,1944960,612768,1776093,37664,120388,470491,1349354,508155,1469742
PI,202010,723594,1950512,615748,1780301,37906,120528,472324,1351350,510230,1471878
PI,202011,706618,1911266,604514,1750243,36508,116298,467298,1339942,503806,1456240
PI,202012,710024,1917160,607172,1754967,36738,116480,469198,1343267,505936,1459747
PR,201401,1258162,3908532,1032337,3449687,305631,1123491,310741,1003912,616372,2127403
PR,201402,1266425,3924774,1034754,3452339,304353,1117346,310237,999166,614590,2116512
PR,201403,1279541,3951539,1039100,3458854,302390,1107094,308621,989133,611011,2096227
PR,201404,1287715,3966526,1040413,3458016,300190,1096866,306782,979562,606972,2076428
PR,201405,1295269,3979351,1041640,3457062,310856,1127039,334404,1075804,645260,2202843
PR,201406,1304699,3996139,1043268,3456628,309611,1120641,332640,1066183,642251,2186824
PR,201407,1308259,3997260,1041304,3445203,307349,1111037,330937,1057817,638286,2168854
PR,201408,1313286,4002989,1039683,3434795,304821,1100957,328735,1046948,633556,2147905
PR,201409,1312627,3975900,1033643,3396513,300716,1080212,325353,1029996,626069,2110208
PR,201410,1318100,3999446,1032696,3403809,298768,1076605,323383,1024783,622151,2101388
PR,201411,1320642,3999538,1030677,3393115,296291,1066804,321402,1015912,617693,2082716
PR,201412,1324514,4003149,1030447,3386999,294417,1058832,319377,1006984,613794,2065816
PR,201501,1196593,3594196,930659,3054621,237729,866961,285403,892216,523132,1759177
PR,201502,1203350,3606618,931361,3053141,235994,859797,283310,884302,519304,1744099
PR,201503,1214072,3629597,934381,3058316,235079,854739,280588,873293,515667,1728032
PR,201504,1223062,3649706,937577,3065066,234236,850137,278375,864024,512611,1714161
PR,201505,1233379,3671319,941084,3071077,232866,842768,276550,855469,509416,1698237
PR,201506,1240829,3686162,942692,3071873,230763,832799,272794,840796,503557,1673595
PR,201507,1198290,3548555,901792,2933538,215813,775867,257533,790319,473346,1566186
PR,201508,1209854,3575973,906183,2943660,214641,769082,254705,778295,469346,1547377
PR,201509,1218891,3596647,910151,2952532,214376,766469,253140,770955,467516,1537424
PR,201510,1227090,3614725,913621,2959427,214222,764274,251834,764476,466056,1528750
PR,201511,1233967,3629909,915956,2963912,214019,762375,250599,759377,464618,1521752
PR,201512,1243316,3651244,920000,2972377,213904,760589,251377,759742,465281,1520331
PR,201601,1160607,3440970,894445,2903881,199983,714231,227814,705620,427797,1419851
PR,201602,1168316,3458978,898469,2913626,200116,714306,229890,711139,430006,1425445
PR,201603,1180459,3488816,905688,2932027,200605,714454,232885,718774,433490,1433228
PR,201604,1195174,3524046,914601,2954663,201095,714457,236352,726917,437447,1441374
PR,201605,1204909,3547576,920614,2969667,201587,714932,238807,732320,440394,1447252
PR,201606,1216118,3572989,925552,2980928,216375,771883,257429,798380,473804,1570263
PR,201607,1230571,3607368,932373,2998015,215929,768192,258833,799860,474762,1568052
PR,201608,1241045,3631600,936013,3006248,200139,703787,240679,730954,440818,1434741
PR,201609,1249707,3651642,874601,2840903,199637,700421,240717,729383,440354,1429804
PR,201610,1259602,3673912,874631,2839336,199149,696328,240453,725446,439602,1421774
PR,201611,1266365,3689334,874940,2839641,199303,695727,240154,722328,439457,1418055
PR,201612,1187275,3476763,814500,2657793,186021,649634,226101,682106,412122,1331740
PR,201701,1193304,3490880,906449,2905016,198583,700364,246819,753735,445402,1454099
PR,201702,1203982,3517220,912863,2922004,198907,700327,250429,764170,449336,1464497
PR,201703,1216765,3548740,920658,2942753,199878,702247,254150,774282,454028,1476529
PR,201704,1233108,3586568,929713,2965242,200292,701809,258250,784486,458542,1486295
PR,201705,1246158,3615338,936439,2980561,200438,700337,260745,788800,461183,1489137
PR,201706,1256390,3636171,941559,2990535,200178,696452,260712,784291,460890,1480743
PR,201707,1268403,3660590,947286,3001579,200460,695450,262851,787066,463311,1482516
PR,201708,1281759,3689053,953467,3015379,200940,695299,265050,791176,465990,1486475
PR,201709,1136425,3262575,844438,2667784,178315,616561,247920,742833,426235,1359394
PR,201710,1159569,3312752,855512,2695226,179143,617738,253142,755587,432285,1373325
PR,201711,1179609,3355314,864358,2717188,179917,619333,257224,765279,437141,1384612
PR,201712,1202206,3402438,873492,2739058,180594,620437,261129,773727,441723,1394164
PR,201801,1214632,3428380,883435,2765283,180771,619882,262953,776580,443724,1396462
PR,201802,1227973,3458528,890341,2781671,181099,619662,266604,785215,447703,1404877
PR,201803,1182048,3320611,852582,2657232,169905,578971,260139,764601,430044,1343572
PR,201804,1199378,3360224,862119,2680398,170757,580473,264463,774258,435220,1354731
PR,201805,1219663,3406929,872726,2706804,171301,580942,269836,786996,441137,1367938
PR,201806,1232457,3435004,878451,2719583,171622,580825,271621,789256,443243,1370081
PR,201807,1244767,3461164,885078,2733933,177375,600106,278135,807569,455510,1407675
PR,201808,1154679,3192280,823534,2530083,168730,569495,274936,797704,443666,1367199
PR,201809,1176071,3239698,834805,2557400,169815,571583,277766,801133,447581,1372716
PR,201810,1201737,3296974,847795,2589215,166326,557978,277619,792552,443945,1350530
PR,201811,1221053,3336136,855337,2605844,166503,557598,279246,792909,445749,1350507
PR,201812,1177125,3195875,818304,2486057,156220,523238,272227,773102,428447,1296340
PR,201901,1192062,3228848,832994,2528751,160564,537346,278891,794382,439455,1331728
PR,201902,1209262,3269518,842276,2551730,161381,539030,282944,803258,444325,1342288
PR,201903,1224916,3305961,850997,2573248,162147,540535,285867,808184,448014,1348719
PR,201904,1214066,3273999,840467,2540204,157791,525299,283839,802468,441630,1327767
PR,201905,1230897,3312233,850013,2563645,158519,526543,287859,811102,446378,1337645
PR,201906,1247642,3350096,859455,2587020,159381,528655,291894,819349,451275,1348004
PR,201907,1262037,3381323,866958,2604946,160081,530387,294083,822715,454164,1353102
PR,201908,1280388,3420251,874263,2621793,160661,530885,296247,825075,456908,1355960
PR,201909,1216338,3216432,823070,2452122,150649,496879,289756,805919,440405,1302798
PR,201910,1237484,3266413,834857,2482880,151809,499414,294076,815586,445885,1315000
PR,201911,1253488,3304828,843516,2505876,152599,501032,297476,823715,450075,1324747
PR,201912,1268294,3339554,851111,2525650,153375,502998,300275,829628,453650,1332626
PR,202001,1275361,3355612,871726,2578911,153768,504068,301647,832833,455415,1336901
PR,202002,1227734,3218177,839548,2483632,149261,489268,299623,827642,448884,1316910
PR,202003,1245352,3260515,851674,2509534,150278,492098,302524,834171,452802,1326269
PR,202004,1251960,3275214,856390,2520735,150873,493360,304940,839680,455813,1333040
PR,202005,1265920,3306540,868584,2549182,152525,497107,310844,852457,463369,1349564
PR,202006,1283687,3347194,883311,2584083,154475,501913,317125,865413,471600,1367326
PR,202007,1297119,3376582,894120,2608815,155772,504954,321985,875029,477757,1379983
PR,202008,1312909,3411685,905619,2635657,157115,507918,326922,885066,484037,1392984
PR,202009,1323189,3433765,913054,2652365,157917,509572,329860,890450,487777,1400022
PR,202010,1336860,3463251,922457,2673664,158962,511400,333543,897282,492505,1408682
PR,202011,1280110,3311015,888520,2570468,152591,490792,327294,881644,479885,1372436
PR,202012,1291139,3336116,895823,2587799,153505,492799,330104,887497,483609,1380296
RJ,201401,1577731,4853763,1433270,4613328,353447,1227872,769659,2458785,1123106,3686657
RJ,201402,1589271,4875807,1440410,4627179,353776,1226883,771454,2458418,1125230,3685301
RJ,201403,1603251,4902066,1448723,4643371,354240,1225350,772283,2454171,1126523,3679521
RJ,201404,1615590,4925741,1456674,4659309,354838,1224411,773794,2452448,1128632,3676859
RJ,201405,1624905,4943045,1462577,4670767,347142,1189208,821639,2608833,1168781,3798041
RJ,201406,1640988,4973557,1473012,4691302,348532,1190591,824418,2609216,1172950,3799807
RJ,201407,1655356,5002516,1482534,4711579,350160,1193886,827920,2613313,1178080,3807199
RJ,201408,1675309,5044952,1496087,4742408,352943,1200385,832487,2619152,1185430,3819537
RJ,201409,1687209,5057729,1503950,4748043,354909,1201408,833129,2610452,1188038,3811860
RJ,201410,1702921,5103830,1514194,4783498,357488,1211902,836039,2618013,1193527,3829915
RJ,201411,1715496,5130416,1522267,4801917,359433,1216681,838363,2620419,1197796,3837100
RJ,201412,1725278,5150965,1528241,4815340,360823,1220061,838573,2616817,1199396,3836878
RJ,201501,1557284,4601626,1378707,4309967,293221,992773,769385,2378715,1062606,3371488
RJ,201502,1566945,4622214,1384815,4324318,294975,997269,770609,2379716,1065584,3376985
RJ,201503,1578761,4647200,1391736,4340721,296846,1001595,771417,2378341,1068263,3379936
RJ,201504,1589908,4671637,1398947,4358105,298312,1004802,773276,2380229,1071588,3385031
RJ,201505,1603582,4701652,1407898,4379858,299679,1007774,776196,2384134,1075875,3391908
RJ,201506,1613586,4721049,1412544,4389099,300171,1007025,772639,2367731,1072810,3374756
RJ,201507,1544101,4501844,1344232,4169103,280147,935810,731989,2235590,1012136,3171400
RJ,201508,1559283,4535539,1351824,4188700,282076,940088,728511,2219774,1010587,3159862
RJ,201509,1570834,4560142,1358111,4203690,284512,945958,725408,2206353,1009920,3152311
RJ,201510,1581364,4582500,1363625,4216930,287028,952448,722415,2193850,1009443,3146298
RJ,201511,1592604,4606613,1370296,4232732,288909,956910,722745,2191698,1011654,3148608
RJ,201512,1604720,4631329,1376914,4247796,290731,961139,722667,2187620,1013398,3148759
RJ,201601,1525313,4423830,1332591,4114754,274129,909060,687978,2094847,962107,3003907
RJ,201602,1533927,4441840,1337492,4126200,274808,910915,690569,2100240,965377,3011155
RJ,201603,1547689,4471721,1346206,4147273,275021,910760,696801,2115407,971822,3026167
RJ,201604,1565907,4511260,1358080,4176022,275335,910629,705804,2137236,981139,3047865
RJ,201605,1581872,4546735,1368256,4201683,276002,911460,713024,2156194,989026,3067654
RJ,201606,1597105,4577918,1375249,4218101,278709,930111,745772,2264731,1024481,3194842
RJ,201607,1615052,4616972,1385195,4242788,279079,928518,748730,2269928,1027809,3198446
RJ,201608,1625658,4638658,1390674,4255117,277403,909261,716809,2157648,994212,3066909
RJ,201609,1636640,4664253,1356292,4176622,278038,909812,719304,2163225,997342,3073037
RJ,201610,1650096,4692915,1362157,4189600,279160,910925,719163,2155771,998323,3066696
RJ,201611,1657654,4708224,1364912,4195356,280193,912806,717625,2147099,997818,3059905
RJ,201612,1541366,4404885,1270551,3922476,260043,848409,679376,2034389,939419,2882798
RJ,201701,1549882,4422786,1332864,4070040,258398,854491,716518,2153633,974916,3008124
RJ,201702,1560055,4443806,1340703,4087086,258859,854420,722244,2166538,981103,3020958
RJ,201703,1570714,4466759,1349052,4105940,259527,855106,728421,2181052,987948,3036158
RJ,201704,1588019,4503173,1362961,4136720,260209,854658,739465,2207187,999674,3061845
RJ,201705,1603149,4534072,1374483,4161360,260763,854289,747221,2223070,1007984,3077359
RJ,201706,1617605,4560481,1384818,4180541,261222,852299,750112,2221543,1011334,3073842
RJ,201707,1640977,4602368,1398267,4207569,262120,851763,757681,2235419,1019801,3087182
RJ,201708,1664134,4645169,1412191,4236374,263480,852979,765937,2251877,1029417,3104856
RJ,201709,1481212,4117689,1254422,3754686,225798,727268,710822,2090309,936620,2817577
RJ,201710,1523507,4199233,1282034,3815189,228201,730771,730156,2133460,958357,2864231
RJ,201711,1555521,4259595,1301496,3858109,229120,731000,745020,2167406,974140,2898406
RJ,201712,1593909,4325025,1318872,3896336,229098,728967,757449,2195282,986547,2924249
RJ,201801,1621597,4373729,1336221,3934362,229364,727876,765258,2209185,994622,2937061
RJ,201802,1640494,4410289,1348966,3961307,229709,727166,774901,2229286,1004610,2956452
RJ,201803,1580243,4226323,1293846,3784412,211273,663729,756593,2167154,967866,2830883
RJ,201804,1605491,4280156,1313109,3828259,212252,664353,771615,2202021,983867,2866374
RJ,201805,1637660,4348554,1338066,3884440,213501,665022,791752,2249176,1005253,2914198
RJ,201806,1660269,4394788,1354436,3920540,214807,666856,802843,2273173,1017650,2940029
RJ,201807,1677011,4427281,1367147,3946064,218286,677244,817959,2312411,1036245,2989655
RJ,201808,1582753,4166927,1298921,3732256,205466,633571,811042,2288331,1016508,2921902
RJ,201809,1614154,4230966,1320712,3780522,207901,637818,823201,2312415,1031102,2950233
RJ,201810,1657762,4320078,1350511,3847489,209985,640389,834319,2325327,1044304,2965716
RJ,201811,1687210,4374667,1367306,3883401,210995,641396,843587,2342195,1054582,2983591
RJ,201812,1633366,4203797,1313498,3719454,194877,590394,825707,2290784,1020584,2881178
RJ,201901,1665871,4264241,1335751,3772819,195042,590376,842016,2334765,1037058,2925141
RJ,201902,1692716,4319164,1354410,3814549,196092,591862,855489,2364107,1051581,2955969
RJ,201903,1711735,4358053,1368663,3845480,197043,593852,864953,2382093,1061996,2975945
RJ,201904,1684397,4289391,1343493,3779353,188492,568999,855596,2360020,1044088,2929019
RJ,201905,1708639,4339019,1361496,3819351,189185,569917,869510,2389769,1058695,2959686
RJ,201906,1738465,4399632,1383247,3867803,190262,571963,886368,2426140,1076630,2998103
RJ,201907,1764131,4448175,1399817,3903170,190928,572674,898244,2450135,1089172,3022809
RJ,201908,1797744,4511086,1419282,3945352,192142,574371,909607,2471261,1101749,3045632
RJ,201909,1730233,4299636,1357850,3749144,177376,527309,893236,2417542,1070612,2944851
RJ,201910,1766841,4375119,1381533,3804472,179002,530584,909024,2452061,1088026,2982645
RJ,201911,1795264,4434084,1400165,3848286,179696,531723,922834,2483373,1102530,3015096
RJ,201912,1822666,4488926,1417491,3888188,180341,532488,935277,2511411,1115618,3043899
RJ,202001,1839888,4522022,1440139,3937463,180964,533827,941601,2524912,1122565,3058739
RJ,202002,1784397,4373872,1396762,3816846,171543,505439,932938,2503238,1104481,3008677
RJ,202003,1807909,4421120,1412499,3850004,172258,506818,941972,2523422,1114230,3030240
RJ,202004,1816471,4438637,1418542,3863581,172637,507349,946090,2532558,1118727,3039907
RJ,202005,1826931,4458082,1426924,3879733,173024,507747,952409,2544388,1125433,3052135
RJ,202006,1838543,4478736,1436239,3896801,173556,508192,959300,2556379,1132856,3064571
RJ,202007,1853642,4504996,1448393,3918619,174240,508840,968556,2572142,1142796,3080982
RJ,202008,1872713,4538743,1463692,3946651,175284,510299,980011,2592237,1155295,3102536
RJ,202009,1888639,4565899,1476272,3968504,176072,510961,989284,2607370,1165356,3118331
RJ,202010,1907380,4598221,1490837,3994293,177055,511911,1000189,2625940,1177244,3137851
RJ,202011,1839216,4432745,1444858,3864981,167334,483301,983741,2580922,1151075,3064223
RJ,202012,1854691,4460937,1457155,3888284,168141,484388,992878,2597559,1161019,3081947
RN,201401,660657,2000709,600814,1898092,121800,418138,348897,1106788,470697,1524926
RN,201402,663955,2005561,602269,1899491,121750,416700,348378,1103604,470128,1520304
RN,201403,668161,2012306,604145,1902019,121668,415176,347495,1098723,469163,1513899
RN,201404,671415,2017548,605853,1904386,121613,413934,347073,1095157,468686,1509091
RN,201405,674272,2021614,607279,1906004,119749,401230,362629,1145400,482378,1546630
RN,201406,678520,2028705,609608,1909741,120171,401948,362661,1142949,482832,1544897
RN,201407,681785,2034461,611421,1912876,120393,402065,362843,1141768,483236,1543833
RN,201408,686151,2041770,613698,1916171,120492,401833,363299,1140357,483791,1542190
RN,201409,688936,2043283,615212,1915392,120882,401683,363080,1136738,483962,1538421
RN,201410,692150,2052296,617159,1921963,121167,402869,363677,1138287,484844,1541156
RN,201411,694450,2056580,618359,1924282,121378,403056,363953,1138418,485331,1541474
RN,201412,697142,2061362,619724,1926507,121561,403276,363717,1136442,485278,1539718
RN,201501,636792,1895128,566487,1775528,99766,338016,341690,1071879,441456,1409895
RN,201502,639962,1901438,567754,1778001,99941,337818,340972,1069206,440913,1407024
RN,201503,642812,1906930,569193,1780804,100434,338666,340166,1065803,440600,1404469
RN,201504,645167,1911480,570490,1783416,100769,339013,339599,1063225,440368,1402238
RN,201505,647964,1916515,571925,1785779,100406,337000,339449,1061104,439855,1398104
RN,201506,650225,1919475,572622,1785571,100609,336801,335694,1046038,436303,1382839
RN,201507,620852,1839850,548075,1712618,94706,316991,322558,1004639,417264,1321630
RN,201508,624306,1846470,549553,1715265,95216,317836,319746,993697,414962,1311533
RN,201509,626643,1850503,550238,1716008,95788,318977,317359,985331,413147,1304308
RN,201510,628688,1853985,551124,1717277,96332,320410,315991,980087,412323,1300497
RN,201511,630486,1856397,551960,1717859,96619,320628,315460,977528,412079,1298156
RN,201512,632827,1860652,553184,1719929,96679,320179,315712,977636,412391,1297815
RN,201601,611759,1818137,542692,1699396,93386,311620,306038,959139,399424,1270759
RN,201602,613903,1822190,543957,1701590,92878,309651,307734,963481,400612,1273132
RN,201603,616773,1827480,546009,1705312,92191,306930,310128,969541,402319,1276471
RN,201604,619662,1832433,548181,1708973,91397,303714,312747,975716,404144,1279430
RN,201605,622636,1837871,550396,1713122,91156,302028,314766,980520,405922,1282548
RN,201606,625162,1840980,551626,1713815,93641,315713,325521,1014152,419162,1329865
RN,201607,628172,1846185,553454,1716770,93244,313030,325988,1014010,419232,1327040
RN,201608,631130,1850671,554737,1717782,91170,298138,314405,974407,405575,1272545
RN,201609,633496,1854462,542458,1687038,91471,298079,314446,973146,405917,1271225
RN,201610,636110,1858345,542535,1685164,91787,297747,313297,967262,405084,1265009
RN,201611,637880,1861133,542300,1683494,92443,298756,311777,961690,404220,1260446
RN,201612,601508,1770737,511864,1600688,86684,280699,298539,926041,385223,1206740
RN,201701,603467,1774097,532436,1649501,84011,279171,313114,969825,397125,1248996
RN,201702,606561,1779438,534481,1652927,83374,276191,315330,975279,398704,1251470
RN,201703,609626,1784903,536562,1656565,83008,274067,317399,980241,400407,1254308
RN,201704,614368,1792496,539807,1661419,82749,271564,319907,984971,402656,1256535
RN,201705,618421,1799471,542506,1665766,82417,269344,321360,986407,403777,1255751
RN,201706,622266,1804760,544805,1668067,82272,267326,320626,979925,402898,1247251
RN,201707,626211,1811654,547102,1671823,82266,266334,321750,981368,404016,1247702
RN,201708,630496,1819660,549459,1676105,82313,265396,322653,982749,404966,1248145
RN,201709,579559,1689144,508415,1561619,72842,235444,309695,950396,382537,1185840
RN,201710,586414,1702792,512371,1569818,72444,233492,313057,958055,385501,1191547
RN,201711,592744,1715445,515709,1577249,72083,231923,315800,964169,387883,1196092
RN,201712,600230,1729607,519055,1584394,71468,229756,318135,968668,389603,1198424
RN,201801,605372,1739444,522617,1592262,71229,228543,319167,969241,390396,1197784
RN,201802,609351,1747108,524983,1596733,70926,227093,320998,972488,391924,1199581
RN,201803,595041,1708795,512784,1560600,66448,212362,317492,961478,383940,1173840
RN,201804,604576,1726685,518594,1572378,66462,211342,321474,969964,387936,1181306
RN,201805,615583,1747094,525493,1586020,66261,209571,326382,980405,392643,1189976
RN,201806,622074,1759007,529841,1594284,66288,209187,329056,984752,395344,1193939
RN,201807,625707,1764922,532352,1598161,67334,213531,332317,992119,399651,1205650
RN,201808,598808,1690545,512195,1535514,62661,198521,330854,985822,393515,1184343
RN,201809,606087,1704268,516797,1544475,62727,197866,332880,987772,395607,1185638
RN,201810,614619,1720720,522343,1555581,62247,195240,333970,985630,396217,1180870
RN,201811,620755,1731351,525778,1561707,62166,194592,335807,987659,397973,1182251
RN,201812,604802,1685261,511396,1518931,58119,182280,331449,974992,389568,1157272
RN,201901,611581,1699540,517405,1533863,57876,181688,336012,987781,393888,1169469
RN,201902,617330,1711245,521011,1541573,57719,180711,338483,992704,396202,1173415
RN,201903,621350,1719060,523495,1546499,57773,180822,339318,992405,397091,1173227
RN,201904,615983,1705093,518454,1532113,55773,174633,337667,987500,393440,1162133
RN,201905,621345,1715101,521955,1538692,55688,173960,340198,991626,395886,1165586
RN,201906,627269,1727224,525782,1546954,55604,173166,342797,997050,398401,1170216
RN,201907,632287,1735988,528556,1552007,55680,172997,344063,998258,399743,1171255
RN,201908,640320,1750972,532217,1558974,55549,171565,345390,999413,400939,1170978
RN,201909,620148,1691566,514098,1504073,52019,160753,341045,986890,393064,1147643
RN,201910,627996,1708016,518588,1514372,52177,160667,343398,991751,395575,1152418
RN,201911,634592,1722550,522570,1524191,52076,159946,346105,998409,398181,1158355
RN,201912,640847,1736030,526249,1533156,51964,159210,348602,1004497,400566,1163707
RN,202001,644639,1744513,532140,1547031,51968,159184,349819,1007368,401787,1166552
RN,202002,628484,1702100,519158,1512296,49852,152471,347874,1003156,397726,1155627
RN,202003,633763,1714016,523171,1520255,49904,152183,349466,1007158,399370,1159341
RN,202004,636719,1719591,525505,1524730,50072,152364,351014,1010029,401086,1162393
RN,202005,642010,1728938,530145,1533212,50532,152998,353568,1013954,404100,1166952
RN,202006,645170,1734631,532729,1537861,50810,153402,354881,1015865,405691,1169267
RN,202007,647341,1738163,534516,1540785,51007,153602,355767,1016993,406774,1170595
RN,202008,650370,1743426,536820,1544896,51301,154075,357052,1019028,408353,1173103
RN,202009,653201,1747446,538879,1547727,51548,154231,358175,1020059,409723,1174290
RN,202010,656755,1753432,541462,1552084,51810,154570,359614,1021997,411424,1176567
RN,202011,639982,1711530,529613,1519737,49762,148837,355814,1012729,405576,1161566
RN,202012,643272,1717404,532045,1524281,50049,149251,357211,1015229,407260,1164480
RO,201401,251065,778560,215276,724375,60145,213641,107887,368774,168032,582415
RO,201402,253012,782099,216068,725956,60426,214494,107609,367191,168035,581685
RO,201403,255438,786079,217198,727765,60808,215231,106974,363991,167782,579222
RO,201404,257713,790223,218297,729897,60943,215200,106519,361736,167462,576936
RO,201405,259422,793092,219136,731397,58139,203260,115540,391873,173679,595133
RO,201406,261817,797322,220287,733468,58622,204736,114970,388831,173592,593567
RO,201407,264296,802174,221420,735982,59008,205925,114496,386222,173504,592147
RO,201408,267248,807911,222697,738742,59531,207593,113712,382359,173243,589952
RO,201409,268285,806425,223128,736086,59945,207911,112969,377553,172914,585464
RO,201410,270049,813016,223894,740961,60427,210528,112522,377054,172949,587582
RO,201411,271176,815151,224463,742113,60731,211537,112178,375440,172909,586977
RO,201412,272649,818010,225012,743245,61097,212698,111391,372341,172488,585039
RO,201501,239578,719613,198487,656158,51346,180262,95769,320555,147115,500817
RO,201502,241045,722481,198966,657170,51504,180758,95356,318824,146860,499582
RO,201503,242778,725792,199776,658854,52258,183150,94236,314353,146494,497503
RO,201504,244007,728092,200269,659903,52713,184619,93552,311600,146265,496219
RO,201505,245667,730990,200968,661081,53164,185949,92725,308002,145889,493951
RO,201506,246942,733238,201344,661543,53505,186775,91237,302311,144742,489086
RO,201507,237549,705787,193302,634956,51376,179017,85078,281517,136454,460534
RO,201508,239198,708915,193522,635183,51613,179593,83418,275357,135031,454950
RO,201509,240431,711229,193763,635541,51975,180694,81998,270110,133973,450804
RO,201510,241729,713612,194127,636154,52370,181915,80867,265849,133237,447764
RO,201511,243029,715962,194485,636815,52677,182856,80046,262726,132723,445582
RO,201512,244850,719606,195051,638155,53152,184386,78952,258660,132104,443046
RO,201601,229574,683399,186946,616298,50456,176150,71110,239306,121566,415456
RO,201602,230984,686047,187471,617515,50616,176553,70926,238558,121542,415111
RO,201603,233085,690374,188395,619825,50929,177408,70621,237162,121550,414570
RO,201604,235439,695146,189436,622396,51012,177479,70685,236889,121697,414368
RO,201605,237462,699107,190472,624735,51117,177566,70800,236785,121917,414351
RO,201606,239279,702838,191219,626499,52558,183472,76040,255912,128598,439384
RO,201607,241482,707599,192252,629122,52747,183902,75737,254273,128484,438175
RO,201608,243281,711084,192838,630289,51495,178327,69657,231424,121152,409751
RO,201609,246719,717333,186614,615215,51601,178240,69234,229686,120835,407926
RO,201610,248837,721494,186909,615775,51887,179036,68447,226382,120334,405418
RO,201611,250017,724098,186971,616020,52103,179606,67778,224028,119881,403634
RO,201612,232711,677943,172388,573099,48566,168359,61299,204457,109865,372816
RO,201701,233543,679537,183096,599029,49744,173084,66680,224076,116424,397160
RO,201702,234885,682133,183853,600531,49943,173507,66761,223985,116704,397492
RO,201703,236589,685883,184916,603151,50330,174536,66819,223951,117149,398487
RO,201704,238805,690332,186266,606120,50969,176331,66796,223303,117765,399634
RO,201705,241199,695029,187664,609049,51416,177358,66794,222606,118210,399964
RO,201706,243232,698759,188754,611055,51786,178100,66345,220114,118131,398214
RO,201707,245705,703562,190064,613780,52233,179196,66146,218824,118379,398020
RO,201708,248100,708399,191246,616430,52716,180364,65689,216900,118405,397264
RO,201709,215930,621272,165789,539057,46116,158138,56733,190392,102849,348530
RO,201710,219867,629238,167477,543278,46418,158945,56888,190283,103306,349228
RO,201711,223285,636186,168897,546878,46592,159328,57299,191224,103891,350552
RO,201712,228207,645094,170175,549852,46552,158906,57520,191558,104072,350464
RO,201801,231370,651012,171693,553698,46605,158832,57483,191162,104088,349994
RO,201802,234011,656799,172862,556639,46875,159553,57652,191388,104527,350941
RO,201803,220926,621100,161914,523052,43569,148167,53762,179551,97331,327718
RO,201804,224327,628393,163746,527468,43854,148693,54474,181343,98328,330036
RO,201805,229494,639389,166612,534399,44215,149297,55790,184956,100005,334253
RO,201806,232950,646286,168412,538477,44426,149580,56387,186215,100813,335795
RO,201807,235832,652086,169945,541874,45382,152357,58124,192046,103506,344403
RO,201808,222107,613526,159296,508059,43067,144289,55946,185578,99013,329867
RO,201809,225932,621717,161223,512750,43439,145100,55925,184937,99364,330037
RO,201810,230517,631682,163542,518471,43215,144014,54853,180054,98068,324068
RO,201811,233528,637887,164804,521439,43404,144340,54889,179691,98293,324031
RO,201812,225504,613816,157528,498548,40982,136519,52728,173213,93710,309732
RO,201901,229061,621022,160012,505570,41633,138550,54289,178858,95922,317408
RO,201902,232748,628796,161952,510220,41942,139227,54690,179800,96632,319027
RO,201903,235599,634940,163511,513930,42207,139889,55006,180273,97213,320162
RO,201904,232976,627787,161051,506396,41138,136113,54179,178041,95317,314154
RO,201905,236716,635778,163091,511417,41644,137479,54566,178686,96210,316165
RO,201906,240550,644017,165186,516616,42135,138695,55017,179690,97152,318385
RO,201907,243978,650903,166805,520448,42493,139644,55247,179971,97740,319615
RO,201908,248408,659651,168608,524614,42870,140622,55302,179421,98172,320043
RO,201909,235333,621179,158462,491492,40251,131694,53463,173600,93714,305294
RO,201910,240678,633042,161260,498695,40742,132979,53995,174569,94737,307548
RO,201911,244401,641041,163220,503633,41039,133618,54605,176044,95644,309662
RO,201912,248109,649294,165144,508643,41274,134236,55149,177348,96423,311584
RO,202001,250475,654539,170121,519325,41466,134725,55482,178185,96948,312910
RO,202002,242152,631943,164216,502063,40165,130480,54802,176296,94967,306776
RO,202003,246138,640752,166647,507162,40453,131125,55341,177698,95794,308823
RO,202004,247483,643344,167553,508989,40645,131502,55601,178148,96246,309650
RO,202005,249262,646670,168944,511723,40824,131755,55974,178768,96798,310523
RO,202006,251098,650304,170348,514648,41122,132410,56218,179053,97340,311463
RO,202007,253012,654025,171860,517728,41317,132761,56661,179904,97978,312665
RO,202008,255103,658163,173281,520728,41524,133134,56984,180476,98508,313610
RO,202009,257422,662498,174738,523515,41803,133634,57179,180569,98982,314203
RO,202010,260016,667250,176314,526548,42139,134289,57364,180613,99503,314902
RO,202011,248126,637724,169107,505107,40201,128200,55862,176384,96063,304584
RO,202012,250202,641577,170397,507661,40382,128405,56157,176920,96539,305325
RR,201401,78592,261324,72857,252425,14188,50105,46813,168364,61001,218469
RR,201402,78989,261953,73104,252798,14186,50056,46951,168436,61137,218492
RR,201403,79563,262899,73516,253500,14315,50518,46953,167792,61268,218310
RR,201404,80103,263714,73866,254032,14559,51363,46678,166238,61237,217601
RR,201405,80496,264213,74109,254278,14017,48582,48571,172343,62588,220925
RR,201406,81251,265659,74578,255269,14085,48839,48686,172131,62771,220970
RR,201407,81928,267132,75053,256424,14182,49228,48858,172286,63040,221514
RR,201408,84007,271762,76533,260109,14688,51003,49161,172309,63849,223312
RR,201409,84940,273804,77138,261605,15037,52243,49018,171421,64055,223664
RR,201410,86447,277523,78100,264498,15339,53206,49237,172033,64576,225239
RR,201411,87088,278917,78516,265541,15499,53692,49299,172049,64798,225741
RR,201412,88015,280889,79059,266900,15680,54334,49353,171884,65033,226218
RR,201501,84398,270056,75653,256856,14635,51121,46877,164671,61512,215792
RR,201502,85765,272783,76501,258817,14831,51607,47070,164888,61901,216495
RR,201503,86790,275007,77180,260533,15026,52192,47252,165276,62278,217468
RR,201504,88036,277533,77998,262447,15243,52651,47464,165634,62707,218285
RR,201505,89600,280844,79013,264913,15502,53450,47462,165046,62964,218496
RR,201506,90672,282927,79565,266121,15829,54471,46948,162852,62777,217323
RR,201507,88096,275972,77099,259155,15529,53939,44715,155524,60244,209463
RR,201508,89095,277657,77527,259954,15809,54583,44181,153537,59990,208120
RR,201509,90116,279531,77977,261012,15982,55050,43906,152463,59888,207513
RR,201510,90886,281172,78395,262115,16161,55634,43664,151596,59825,207230
RR,201511,91841,283112,78926,263426,16301,56023,43673,151438,59974,207461
RR,201512,92497,284595,79326,264501,16427,56360,43746,151668,60173,208028
RR,201601,88224,274395,76927,258024,15752,54487,41470,146112,57222,200599
RR,201602,89054,276629,77473,259848,15784,54641,41787,147265,57571,201906
RR,201603,90242,279254,78167,261773,15808,54646,42183,148493,57991,203139
RR,201604,91193,281343,78850,263462,15653,53934,42820,150413,58473,204347
RR,201605,91894,283128,79372,264961,15618,53769,43246,151739,58864,205508
RR,201606,92514,284640,79759,266080,15895,55141,45215,158715,61110,213856
RR,201607,93109,285855,80090,266852,15886,54966,45149,158281,61035,213247
RR,201608,93550,286560,80292,267144,15610,53404,43256,151256,58866,204660
RR,201609,93751,286708,78431,262736,15555,53158,43168,150722,58723,203880
RR,201610,93771,286135,78218,261703,15468,52792,42996,149840,58464,202632
RR,201611,93825,285975,78100,261182,15447,52671,42829,149127,58276,201798
RR,201612,91721,280388,76183,255740,15037,51484,41805,145994,56842,197478
RR,201701,92121,281138,79088,262340,15146,52298,43748,152645,58894,204943
RR,201702,92893,282736,79569,263547,15166,52268,44024,153412,59190,205680
RR,201703,93267,283432,79788,264025,15149,52211,44198,153832,59347,206043
RR,201704,93811,284276,80133,264556,15166,52144,44386,154019,59552,206163
RR,201705,94307,285272,80416,265238,15172,52068,44502,154304,59674,206372
RR,201706,94890,286474,80772,266068,15221,52142,44497,154110,59718,206252
RR,201707,95425,287538,81069,266768,15274,52257,44492,153845,59766,206102
RR,201708,95865,288197,81175,266884,15307,52256,44261,152960,59568,205216
RR,201709,86735,263672,73624,244832,13554,46446,41627,145568,55181,192014
RR,201710,87466,265352,74083,246100,13680,46815,41733,145762,55413,192577
RR,201711,88218,266966,74565,247323,13746,47009,41975,146296,55721,193305
RR,201712,89239,269069,75148,248791,13857,47296,42110,146470,55967,193766
RR,201801,90283,271084,75854,250421,13994,47656,42272,146669,56266,194325
RR,201802,91733,274410,76749,252895,14332,48808,42424,146861,56756,195669
RR,201803,89219,266855,74182,245097,13699,46652,40918,142097,54617,188749
RR,201804,90979,270935,75393,248287,14066,47696,41259,142848,55325,190544
RR,201805,92797,274923,76710,251413,14262,48150,41854,144050,56116,192200
RR,201806,94316,278042,77788,253880,14353,48391,42553,145510,56906,193901
RR,201807,95480,280427,78639,255803,14933,50192,43390,147980,58323,198172
RR,201808,91296,268958,75509,246007,14291,48037,42936,146253,57227,194290
RR,201809,92232,271549,76218,248252,14448,48472,43260,147377,57708,195849
RR,201810,93899,274860,77546,250993,14387,48115,43476,146589,57863,194704
RR,201811,95488,277758,78866,253475,14609,48604,44267,147798,58876,196402
RR,201812,92753,269708,76658,246158,14078,46700,43482,144908,57560,191608
RR,201901,94105,272735,77828,249234,14402,47438,44317,147690,58719,195128
RR,201902,95954,276774,79250,252637,14593,47843,45198,149719,59791,197562
RR,201903,97180,279507,80229,255019,14686,48062,45865,151278,60551,199340
RR,201904,96001,276260,79328,251968,14319,46662,45763,150796,60082,197458
RR,201905,97396,279607,80436,254823,14491,47078,46429,152460,60920,199538
RR,201906,98726,282735,81424,257382,14645,47448,47026,154020,61671,201468
RR,201907,99768,284987,82153,259161,14803,47737,47414,154952,62217,202689
RR,201908,101431,288692,83228,261995,15012,48241,47934,156359,62946,204600
RR,201909,96177,272958,78908,248018,13894,44414,47007,153189,60901,197603
RR,201910,98149,277907,80386,252232,14030,44642,47985,156127,62015,200769
RR,201911,99501,281171,81440,255061,14125,44843,48753,158250,62878,203093
RR,201912,100636,283943,82266,257357,14193,44948,49259,159774,63452,204722
RR,202001,101909,287016,83923,261269,14378,45463,49811,161168,64189,206631
RR,202002,99383,280807,82221,256346,13826,43743,50231,162164,64057,205907
RR,202003,101124,285417,83659,260410,13980,44209,51160,164884,65140,209093
RR,202004,101688,286789,84081,261544,14095,44558,51296,165141,65391,209699
RR,202005,102228,288228,84521,262797,14232,45012,51402,165403,65634,210415
RR,202006,102554,288866,84806,263389,14264,45091,51571,165734,65835,210825
RR,202007,102686,289013,84907,263500,14269,45103,51635,165791,65904,210894
RR,202008,103250,290063,85353,264359,14343,45244,51805,166058,66148,211302
RR,202009,103569,290644,85603,264853,14378,45301,51892,166178,66270,211479
RR,202010,104048,291324,85927,265312,14413,45330,52022,166264,66435,211594
RR,202011,99731,280638,82716,256341,13677,43131,50837,163120,64514,206251
RR,202012,100096,281129,82994,256691,13701,43141,51013,163344,64714,206485
RS,201401,1155973,3435752,966559,3080631,268089,927351,418690,1321644,686779,2248995
RS,201402,1163982,3450204,969046,3083926,267922,925487,417421,1314783,685343,2240270
RS,201403,1174979,3470513,972734,3089570,267579,922089,415948,1306620,683527,2228709
RS,201404,1183154,3485734,975751,3094211,267352,919742,414749,1299568,682101,2219310
RS,201405,1191206,3499943,978195,3097399,265754,905706,445102,1399929,710856,2305635
RS,201406,1201369,3516801,981057,3100281,265582,903323,444332,1393700,709914,2297023
RS,201407,1209648,3530279,983198,3101958,265450,901472,443813,1388615,709263,2290087
RS,201408,1220231,3548600,986148,3105376,265541,900411,443340,1383143,708881,2283554
RS,201409,1228276,3555977,988025,3100822,265637,897757,442151,1374333,707788,2272090
RS,201410,1237473,3580463,991221,3112764,265819,899390,442014,1373035,707833,2272425
RS,201411,1243073,3589127,992505,3112649,265429,897210,441158,1367666,706587,2264876
RS,201412,1249578,3599335,993908,3112927,264899,894628,439685,1360572,704584,2255200
RS,201501,1087639,3103709,854023,2674188,201528,692488,378486,1163928,580014,1856416
RS,201502,1094731,3118701,856766,2680625,201969,693172,377609,1160167,579578,1853339
RS,201503,1103879,3137182,860126,2687289,202812,694575,375569,1151633,578381,1846208
RS,201504,1111455,3152687,863161,2693640,203523,696028,374010,1144354,577533,1840382
RS,201505,1120328,3170050,866477,2699681,203406,694350,372197,1135956,575603,1830306
RS,201506,1126148,3180527,867794,2700366,203081,691728,368011,1119969,571092,1811697
RS,201507,1079789,3037516,822893,2557039,188595,640427,345511,1047977,534106,1688404
RS,201508,1087747,3054843,825784,2563228,188990,640541,342296,1034872,531286,1675413
RS,201509,1093658,3066982,828107,2567971,190083,643454,339496,1024105,529579,1667559
RS,201510,1098904,3077309,830107,2571548,190908,645268,337321,1015588,528229,1660856
RS,201511,1104193,3087730,832333,2575785,191523,646248,336680,1012110,528203,1658358
RS,201512,1111069,3101432,834704,2580194,192174,647643,336212,1008416,528386,1656059
RS,201601,1038866,2928382,801475,2495285,179159,608621,307431,939854,486590,1548475
RS,201602,1044051,2939284,803860,2500452,179543,609548,308588,942103,488131,1551651
RS,201603,1051191,2954894,807498,2508878,180070,610528,310215,945485,490285,1556013
RS,201604,1059965,2973638,812390,2519635,180235,609986,313008,951564,493243,1561550
RS,201605,1066989,2988908,816298,2528528,180480,610138,315174,956159,495654,1566297
RS,201606,1073782,3002159,818662,2532340,186394,633736,332859,1016268,519253,1650004
RS,201607,1081704,3018635,822506,2540192,186318,631940,333352,1015113,519670,1647053
RS,201608,1087454,3029826,824232,2542852,180624,605894,313571,944736,494195,1550630
RS,201609,1092325,3039730,787483,2447800,180651,604723,313091,941636,493742,1546359
RS,201610,1097735,3050228,787148,2445080,180541,602877,311546,934201,492087,1537078
RS,201611,1101415,3058255,786486,2443104,180894,603248,309673,927458,490567,1530706
RS,201612,1015986,2848821,725158,2271321,167901,561630,288363,868566,456264,1430196
RS,201701,1021022,2859942,780837,2413679,171153,578750,309121,936930,480274,1515680
RS,201702,1026645,2871749,783797,2420169,171134,577858,310966,941334,482100,1519192
RS,201703,1033227,2885903,787532,2428642,171382,577591,313111,946677,484493,1524268
RS,201704,1042964,2905697,793203,2440542,171556,576258,316430,954060,487986,1530318
RS,201705,1051716,2923613,798336,2451209,171739,575152,318878,958616,490617,1533768
RS,201706,1059210,2936866,802187,2456921,171826,573485,318839,953896,490665,1527381
RS,201707,1069764,2957092,807565,2466809,172563,573942,320862,956276,493425,1530218
RS,201708,1078890,2975056,811705,2475076,172968,573658,322209,958192,495177,1531850
RS,201709,922605,2553053,693266,2123920,146634,487173,286745,860728,433379,1347901
RS,201710,938756,2586058,701430,2142493,147391,488224,291589,871784,438980,1360008
RS,201711,957258,2621995,709867,2161420,148172,489469,296670,883414,444842,1372883
RS,201712,979621,2663573,718350,2180215,148623,489879,301387,893156,450010,1383035
RS,201801,997819,2697658,728381,2203880,148849,489477,304441,898138,453290,1387615
RS,201802,1011614,2725010,734914,2217994,149209,489625,307931,905054,457140,1394679
RS,201803,955020,2572927,691515,2086540,136970,448556,295944,868417,432914,1316973
RS,201804,969287,2603316,699879,2105545,137784,450113,300828,878900,438612,1329013
RS,201805,985795,2638359,709877,2128150,138575,451086,307037,892731,445612,1343817
RS,201806,996473,2660229,716158,2141962,138877,450976,310184,898648,449061,1349624
RS,201807,1004804,2676067,721229,2151592,142379,461491,316155,914607,458534,1376098
RS,201808,928310,2467618,669988,1992550,133564,431783,310174,896621,443738,1328404
RS,201809,942523,2497016,677883,2009851,134573,433847,312805,899198,447378,1333045
RS,201810,960019,2534106,687694,2032187,133405,429296,313233,892269,446638,1321565
RS,201811,974567,2562653,694642,2047146,133740,429344,315722,895281,449462,1324625
RS,201812,929860,2432926,658777,1937140,123468,396194,304762,863581,428230,1259775
RS,201901,944862,2463055,670064,1966719,125399,401742,311949,884720,437348,1286462
RS,201902,956680,2488369,676725,1982237,125909,402674,315586,892245,441495,1294919
RS,201903,967104,2510433,683025,1996104,126401,403506,318473,896767,444874,1300273
RS,201904,949280,2464789,667770,1953090,121194,386674,313267,883350,434461,1270024
RS,201905,961614,2490572,675011,1969623,121839,388132,317357,891267,439196,1279399
RS,201906,975613,2519836,683223,1988505,122662,389804,321752,900412,444414,1290216
RS,201907,988067,2544307,689607,2002659,123318,391202,324264,904316,447582,1295518
RS,201908,1003955,2575372,696282,2017426,123837,391973,327126,908394,450963,1300367
RS,201909,949696,2409833,651495,1875763,113790,359218,317668,879510,431458,1238728
RS,201910,966618,2446373,660438,1897570,114817,361454,321736,887736,436553,1249190
RS,201911,979796,2474854,667606,1915089,115266,362062,325885,897299,441151,1259361
RS,201912,994150,2505891,674973,1933373,115727,362925,329794,906283,445521,1269208
RS,202001,1003938,2525990,689902,1969076,115947,363362,332122,911521,448069,1274883
RS,202002,963159,2415798,662413,1890296,110580,346480,328295,901236,438875,1247716
RS,202003,977455,2447012,670967,1908915,111256,347901,331657,908930,442913,1256831
RS,202004,983572,2458968,675441,1918029,111892,349235,333947,913255,445839,1262490
RS,202005,995087,2480937,684983,1937290,113130,351465,338987,923006,452117,1274471
RS,202006,1006561,2503500,694139,1956154,114318,353740,343673,931696,457991,1285436
RS,202007,1015760,2521088,701362,1970363,115145,355119,347491,938689,462636,1293808
RS,202008,1025660,2540105,709020,1985523,116127,356925,351535,945977,467662,1302902
RS,202009,1033365,2554167,714702,1996176,116875,358185,354384,950335,471259,1308520
RS,202010,1042796,2572082,721336,2009235,117637,359243,357872,956564,475509,1315807
RS,202011,998836,2461469,693768,1930832,112031,341458,349581,935733,461612,1277191
RS,202012,1006071,2476023,699010,1941881,112873,343198,352217,940904,465090,1284102
SC,201401,488364,1564022,381775,1341006,115422,448252,118234,397524,233656,845776
SC,201402,491803,1570606,382586,1341968,115057,446417,118094,395973,233151,842390
SC,201403,498172,1583732,384525,1345574,114526,443470,118197,394478,232723,837948
SC,201404,502419,1591174,385265,1345632,113726,439372,118086,392690,231812,832062
SC,201405,505956,1597671,385952,1346020,116417,447115,129324,434341,245741,881456
SC,201406,511394,1607412,386658,1345637,115541,443040,129201,432337,244742,875377
SC,201407,512678,1605125,384392,1335728,113947,436630,127907,426527,241854,863157
SC,201408,518774,1617613,385925,1338002,113476,433941,127817,424350,241293,858291
SC,201409,522275,1618915,386337,1332969,113156,430741,127012,418724,240168,849465
SC,201410,526675,1633481,387428,1339496,113150,431817,126769,417835,239919,849652
SC,201411,529783,1639255,388002,1339567,112862,430076,126363,415432,239225,845508
SC,201412,532711,1644860,388360,1339093,112629,428775,125798,412264,238427,841039
SC,201501,461282,1397661,330896,1129900,83599,321988,106213,341369,189812,663357
SC,201502,463684,1402688,331527,1131209,83627,321761,105864,339617,189491,661378
SC,201503,466974,1408877,332257,1131873,83409,320043,105454,337078,188863,657121
SC,201504,469588,1413987,332843,1132447,83186,318425,105123,335183,188309,653608
SC,201505,473580,1422664,334092,1135091,82889,316753,104844,333218,187733,649971
SC,201506,476607,1428513,334557,1135113,82357,313934,103566,327771,185923,641705
SC,201507,448831,1337750,310610,1050519,74292,281982,96358,302631,170650,584613
SC,201508,453493,1349304,312153,1054825,74128,280771,95760,299711,169888,580482
SC,201509,456223,1355540,312992,1056551,73967,279703,95108,296461,169075,576164
SC,201510,458559,1360769,313728,1057970,74001,279501,94647,294072,168648,573573
SC,201511,460113,1363507,313913,1057434,73772,278150,94292,292261,168064,570411
SC,201512,461245,1365947,313882,1056556,73519,276882,94278,291663,167797,568545
SC,201601,421069,1260582,297393,1009773,66924,253555,80896,259479,147820,513034
SC,201602,423127,1265144,298337,1012086,67060,253881,81499,261048,148559,514929
SC,201603,426991,1274390,300438,1017604,67341,254501,82621,263906,149962,518407
SC,201604,431358,1285442,302928,1024531,67613,255174,83943,267489,151556,522663
SC,201605,435653,1295929,305398,1031257,67820,255376,85192,270897,153012,526273
SC,201606,440049,1306766,307348,1036562,73041,275945,91745,295201,164786,571146
SC,201607,444702,1318373,309760,1043218,73258,276187,92496,296526,165754,572713
SC,201608,447846,1325648,311223,1046702,68058,254198,86400,272065,154458,526263
SC,201609,450664,1332116,292783,994576,68171,254188,86727,272103,154898,526291
SC,201610,453699,1339139,293236,995371,67986,252790,86523,270331,154509,523121
SC,201611,455718,1343551,293138,994928,67816,251775,86459,269642,154275,521417
SC,201612,421848,1254107,270863,926939,63311,235776,80765,253410,144076,489186
SC,201701,423162,1257167,298440,1004369,67914,254702,87337,277898,155251,532600
SC,201702,425738,1263050,299997,1008077,67930,254479,88462,280820,156392,535299
SC,201703,429316,1271690,302101,1013547,68175,254992,89663,284003,157838,538995
SC,201704,433460,1280779,304519,1018955,68277,254317,91124,287678,159401,541995
SC,201705,437321,1289369,306818,1024241,68311,253679,92239,289792,160550,543471
SC,201706,440288,1295216,308316,1026857,68176,252103,92327,288404,160503,540507
SC,201707,445389,1306680,311007,1033269,68413,251979,93304,289884,161717,541863
SC,201708,448849,1313536,312426,1035879,68247,250890,94322,291827,162569,542717
SC,201709,373732,1094893,260318,866012,56902,209983,84376,263036,141278,473019
SC,201710,381327,1112082,263973,875495,57193,210565,86417,268117,143610,478682
SC,201711,387862,1126842,266930,883080,57445,210981,88025,272107,145470,483088
SC,201712,395391,1143007,269825,890149,57588,211009,89453,275594,147041,486603
SC,201801,398444,1149151,272707,897712,57539,210469,89937,276153,147476,486622
SC,201802,402046,1157257,274637,902259,57618,210289,91030,278481,148648,488770
SC,201803,380309,1094264,258876,849773,52979,192798,87728,267723,140707,460521
SC,201804,386843,1110154,262759,860101,53556,194180,89508,272033,143064,466213
SC,201805,394202,1128344,267167,871820,54010,194986,91779,277951,145789,472937
SC,201806,399387,1141060,270093,879763,54346,195659,92844,280425,147190,476084
SC,201807,404778,1153465,273120,887166,56409,203032,95208,287131,151617,490163
SC,201808,367805,1045844,250277,809507,53256,191356,93908,283289,147164,474645
SC,201809,375537,1064274,254316,820322,53748,192398,95180,285921,148928,478319
SC,201810,385468,1087997,259548,834201,52755,187843,95758,284637,148513,472480
SC,201811,392451,1103117,262677,841489,53040,188512,96591,285045,149631,473557
SC,201812,371528,1039027,246820,788733,48773,173567,93394,275662,142167,449229
SC,201901,376295,1050210,251833,803277,50248,178811,95741,283234,145989,462045
SC,201902,382385,1064735,255198,812096,50622,179700,97239,286654,147861,466354
SC,201903,389119,1081369,259135,822734,51083,180780,98634,289736,149717,470516
SC,201904,384507,1068049,254690,809062,49316,174854,97468,286698,146784,461552
SC,201905,391345,1084226,258791,819923,49779,176002,99241,290576,149020,466578
SC,201906,398607,1101246,263059,831173,50329,177637,101185,295049,151514,472686
SC,201907,405076,1116250,266705,840861,50844,179108,102395,297400,153239,476508
SC,201908,413066,1134582,270501,850808,51440,180720,103474,299090,154914,479810
SC,201909,389492,1058435,251458,785680,47418,166477,100166,288884,147584,455361
SC,201910,398552,1080549,256373,799426,48234,168967,101957,292772,150191,461739
SC,201911,405056,1096634,260067,809744,48681,170400,103631,296847,152312,467247
SC,201912,411361,1112099,263484,819344,49225,172030,104928,300038,154153,472068
SC,202001,414112,1118323,270462,837025,49328,172380,105540,301373,154868,473753
SC,202002,393865,1059766,257537,796797,47301,165156,104195,297858,151496,463014
SC,202003,401757,1079307,262534,809002,47903,166878,105838,301730,153741,468608
SC,202004,403481,1083238,263700,811787,48032,167139,106437,303124,154469,470263
SC,202005,408899,1095947,268241,822923,48486,168096,108962,308987,157448,477083
SC,202006,413952,1108373,272505,833844,49090,169571,111026,313714,160116,483285
SC,202007,417921,1117903,275769,842019,49451,170459,112729,317612,162180,488071
SC,202008,422155,1127866,278969,849867,49783,171133,114380,321224,164163,492357
SC,202009,425777,1136334,281665,856467,50042,171529,115758,324220,165800,495749
SC,202010,430672,1147660,285054,864831,50295,171998,117396,327705,167691,499703
SC,202011,407935,1087219,271103,822192,47504,162818,114140,319314,161644,482132
SC,202012,412250,1097563,274018,829534,47878,163742,115467,322240,163345,485982
SE,201401,439274,1303609,407519,1256673,66297,219337,277259,862492,343556,1081829
SE,201402,442279,1308121,409430,1259359,66706,219944,277389,860682,344095,1080626
SE,201403,445810,1313414,411438,1262209,67294,220592,277104,857998,344398,1078590
SE,201404,448642,1317393,413126,1264365,67460,220289,276906,855212,344366,1075501
SE,201405,451359,1320866,414626,1266051,65576,209964,285949,882865,351525,1092829
SE,201406,452438,1319693,414322,1262713,65303,208762,285093,878355,350396,1087117
SE,201407,454433,1322381,415416,1264027,65340,208643,285403,877785,350743,1086428
SE,201408,458193,1328359,417816,1267915,65848,209601,286102,877641,351950,1087242
SE,201409,460215,1330238,418959,1268451,66447,210754,285601,874390,352048,1085144
SE,201410,462655,1335843,420620,1272729,66972,212347,285901,874607,352873,1086954
SE,201411,464978,1339879,422047,1275394,67477,213702,286006,874017,353483,1087719
SE,201412,466805,1342973,423030,1277172,67930,214869,285727,872433,353657,1087302
SE,201501,437224,1266608,398515,1209623,59129,189573,273305,838112,332434,1027685
SE,201502,438389,1268318,398871,1209949,59355,190080,272739,836063,332094,1026143
SE,201503,440571,1272284,400118,1212472,60038,191785,272204,833714,332242,1025499
SE,201504,442318,1275402,401219,1214559,60643,193395,271793,831529,332436,1024924
SE,201505,444575,1279171,402606,1217030,60713,193270,271728,830043,332441,1023313
SE,201506,445830,1279879,402826,1215810,61226,194559,267943,815437,329169,1009996
SE,201507,435514,1252812,393505,1189443,60012,191097,259082,786931,319094,978028
SE,201508,437544,1256203,394313,1190690,61183,194423,256090,776148,317273,970571
SE,201509,439458,1258993,395004,1191367,62172,197297,253966,768730,316138,966027
SE,201510,440969,1260769,395718,1191834,63143,200218,252235,762188,315378,962406
SE,201511,442638,1263119,396648,1193040,63443,200727,252073,761004,315516,961731
SE,201512,444761,1266142,397735,1194310,63544,200560,252294,760564,315838,961124
SE,201601,435025,1247561,393649,1186206,61995,196734,247334,751256,309329,947990
SE,201602,437140,1251117,395096,1188701,61522,195261,249133,755168,310655,950429
SE,201603,439846,1255550,397138,1192070,60879,192713,251546,760597,312425,953310
SE,201604,443611,1260750,400077,1196125,60215,189805,254502,766412,314717,956217
SE,201605,446827,1265959,402361,1199968,59836,188032,256635,771047,316471,959079
SE,201606,450398,1270603,404195,1201969,59667,191663,265173,795038,324840,986701
SE,201607,453428,1274749,405978,1204215,59207,189388,266110,795807,325317,985195
SE,201608,456323,1277816,407546,1205096,60138,185784,257646,767875,317784,953659
SE,201609,459199,1281607,400743,1188803,60667,186209,258372,768295,319039,954504
SE,201610,461693,1284112,401757,1188621,61280,186965,258205,765105,319485,952070
SE,201611,463349,1285957,402059,1187886,62080,188430,257377,761506,319457,949936
SE,201612,441787,1234707,383986,1140517,59566,181044,247507,734848,307073,915892
SE,201701,443087,1236389,397104,1168136,53876,169973,260408,770018,314284,939991
SE,201702,445416,1239578,398789,1170343,53762,168841,261914,772808,315676,941649
SE,201703,448465,1243785,401224,1173609,53828,168091,263969,776492,317797,944583
SE,201704,452806,1250047,404616,1178496,53687,166207,267082,782761,320769,948968
SE,201705,456285,1254445,407216,1181595,53668,164992,268624,784140,322292,949132
SE,201706,458687,1256443,408855,1182373,53768,164028,268353,779909,322121,943937
SE,201707,461208,1259383,410504,1183971,53962,163910,269143,780001,323105,943911
SE,201708,464702,1264325,412964,1187358,54181,163712,270266,780728,324447,944440
SE,201709,430055,1179535,384570,1112036,47891,144853,259883,755680,307774,900533
SE,201710,435957,1189139,388494,1118897,47611,143402,263285,762141,310896,905543
SE,201711,441935,1198508,391416,1124324,47298,142088,265834,767242,313132,909330
SE,201712,448526,1208386,394376,1129557,46915,140662,267774,770196,314689,910858
SE,201801,453869,1216064,397358,1134396,46552,139309,268683,769361,315235,908670
SE,201802,457625,1222063,400013,1138660,46430,138508,270539,772045,316969,910553
SE,201803,447044,1192494,390873,1110921,43333,129058,267426,760889,310759,889947
SE,201804,455096,1205276,396514,1120219,43598,128800,271119,767268,314717,896068
SE,201805,463638,1219135,402436,1130333,43760,128095,275483,775124,319243,903219
SE,201806,468170,1226228,405612,1135459,43794,127849,277500,777605,321294,905454
SE,201807,470854,1228971,407607,1137183,44558,130727,279319,779654,323877,910381
SE,201808,453033,1182271,395093,1098568,42151,122938,277845,773138,319996,896076
SE,201809,458396,1189770,398899,1103791,42362,122933,279737,773705,322099,896638
SE,201810,464541,1199171,403247,1110590,43294,124094,280193,770225,323487,894319
SE,201811,468698,1205319,405795,1114325,43598,124481,281210,770349,324808,894830
SE,201812,459463,1180059,396545,1089605,41297,118116,276858,758687,318155,876803
SE,201901,466621,1193065,400935,1099884,39719,114091,280351,766964,320070,881055
SE,201902,470965,1200808,403921,1105400,39737,113529,282227,770268,321964,883797
SE,201903,474044,1205638,406144,1108906,39734,113456,283341,770771,323075,884227
SE,201904,470165,1195093,402492,1098306,38595,109854,281516,765612,320111,875466
SE,201905,474922,1202574,406038,1104027,38611,109391,283903,769026,322514,878417
SE,201906,478489,1208482,408700,1108544,38700,109237,285670,771825,324370,881062
SE,201907,480750,1211886,410121,1110818,38848,109499,286269,772230,325117,881729
SE,201908,485470,1219130,412769,1114897,39034,109570,287354,772534,326388,882104
SE,201909,471873,1182642,401445,1082397,36709,103026,284474,764400,321183,867426
SE,201910,477063,1192120,404880,1089186,36959,103258,286414,767922,323373,871180
SE,201911,481222,1200004,407684,1095070,37130,103416,288102,771506,325232,874922
SE,201912,485370,1207583,410390,1100455,37412,103525,289520,774615,326932,878140
SE,202001,488150,1213177,414687,1109046,37520,103718,290310,776141,327830,879859
SE,202002,476814,1186864,406468,1088309,36340,100223,288726,772672,325066,872895
SE,202003,480455,1194028,409372,1093540,36599,100570,289914,775247,326513,875817
SE,202004,482049,1196050,410505,1094906,36697,100609,290529,775715,327226,876324
SE,202005,484039,1198966,412111,1097235,36897,100834,291192,776137,328089,876971
SE,202006,485651,1201608,413426,1099420,37118,101222,291570,776522,328688,877744
SE,202007,487228,1203840,414650,1101158,37319,101482,292020,776859,329339,878341
SE,202008,489098,1206640,416117,1103399,37583,101891,292698,777703,330281,879594
SE,202009,491218,1208908,417779,1105060,37978,102492,293307,777387,331285,879879
SE,202010,493779,1212447,419714,1107735,38302,102857,294310,778543,332612,881400
SE,202011,480929,1185160,411079,1086821,37019,99632,291273,771850,328292,871482
SE,202012,483124,1188787,412797,1089750,37241,99798,292292,773597,329533,873395
SP,201401,3434676,10876683,3008799,10036855,867471,3163679,1167737,3755049,2035208,6918728
SP,201402,3469414,10950656,3030461,10082496,866322,3152213,1176286,3769020,2042608,6921233
SP,201403,3514957,11050334,3058134,10144140,864214,3135438,1185814,3783412,2050028,6918850
SP,201404,3540128,11096105,3068535,10157612,859022,3109287,1187111,3774330,2046133,6883617
SP,201405,3559851,11128185,3074857,10159090,868631,3129621,1282388,4092935,2151019,7222556
SP,201406,3593062,11193542,3089331,10182102,867017,3116205,1284993,4085363,2152010,7201568
SP,201407,3627511,11268208,3106259,10218492,867230,3111439,1289515,4087627,2156745,7199066
SP,201408,3668287,11345068,3121761,10239902,865434,3097542,1292851,4078536,2158285,7176078
SP,201409,3620634,11161225,3062934,10031740,844602,3020448,1261509,3969273,2106111,6989721
SP,201410,3606187,11129762,3033544,9965144,832662,2990091,1244400,3919852,2077062,6909943
SP,201411,3633486,11185561,3047017,9990494,833081,2986092,1248582,3922348,2081663,6908440
SP,201412,3663815,11249204,3061946,10022437,834156,2985585,1252239,3924455,2086395,6910040
SP,201501,3390815,10279785,2839400,9198749,708774,2528293,1167294,3612754,1876068,6141047
SP,201502,3428036,10364228,2858880,9245543,710381,2529238,1174674,3626744,1885055,6155982
SP,201503,3469382,10455944,2880391,9295291,711994,2528409,1182423,3639403,1894417,6167812
SP,201504,3498565,10519443,2896132,9330107,712796,2525656,1188032,3647560,1900828,6173216
SP,201505,3530211,10583442,2911849,9360604,711864,2516229,1193589,3651298,1905453,6167527
SP,201506,3559882,10645771,2924868,9386614,712234,2510324,1190315,3629354,1902549,6139678
SP,201507,3423824,10161341,2785375,8890618,661665,2313967,1137374,3446626,1799039,5760593
SP,201508,3469600,10270497,2808846,8950628,664856,2317696,1136375,3430956,1801231,5748652
SP,201509,3505587,10355194,2826638,8995702,669008,2326140,1133547,3413293,1802555,5739433
SP,201510,3543071,10442779,2846518,9045747,673267,2335877,1133586,3404707,1806853,5740584
SP,201511,3581670,10525619,2865630,9089164,676475,2342105,1136751,3404559,1813226,5746664
SP,201512,3622697,10615118,2885386,9133318,678690,2344944,1141548,3407479,1820238,5752423
SP,201601,3429919,10086703,2801418,8878239,635229,2196378,1069137,3225223,1704366,5421601
SP,201602,3462938,10163649,2821588,8928092,638020,2202761,1080300,3251291,1718320,5454052
SP,201603,3505609,10264844,2849732,8998867,641204,2209669,1096763,3291441,1737967,5501110
SP,201604,3559543,10393156,2887687,9094368,645427,2218972,1119889,3348683,1765316,5567655
SP,201605,3603556,10498012,2918419,9172779,649080,2227227,1138205,3395038,1787285,5622265
SP,201606,3648441,10601992,2940657,9228394,672272,2323254,1207367,3630320,1879639,5953574
SP,201607,3704782,10734191,2974726,9313341,675326,2326312,1221297,3659859,1896623,5986171
SP,201608,3747728,10832257,2997750,9368567,656558,2231586,1161049,3434496,1817607,5666082
SP,201609,3786476,10923333,2885601,9072404,659649,2235914,1169769,3450127,1829418,5686041
SP,201610,3831557,11031532,2903073,9115148,662651,2238542,1174125,3447733,1836776,5686275
SP,201611,3859199,11096693,2911363,9137057,665007,2241881,1173840,3439922,1838847,5681803
SP,201612,3632216,10460801,2715789,8543383,620329,2085639,1113296,3260478,1733625,5346117
SP,201701,3664214,10534125,2930908,9104834,637958,2169944,1192539,3518095,1830497,5688039
SP,201702,3708418,10638029,2961659,9181202,641784,2178232,1210742,3562865,1852526,5741097
SP,201703,3759157,10755858,2996689,9269399,646410,2189250,1232321,3616197,1878731,5805447
SP,201704,3830987,10917074,3044793,9385688,652205,2201665,1261213,3683846,1913418,5885511
SP,201705,3881740,11035334,3078842,9468912,656406,2209982,1277353,3715587,1933759,5925569
SP,201706,3921785,11122775,3103009,9522440,659416,2212637,1276113,3691447,1935529,5904084
SP,201707,3975110,11240396,3133573,9593348,663347,2218622,1286536,3706851,1949883,5925473
SP,201708,4020096,11340198,3159589,9654390,667644,2226403,1295051,3720957,1962695,5947360
SP,201709,3579104,10048729,2807711,8551098,585997,1946469,1206373,3468166,1792370,5414635
SP,201710,3659159,10227609,2854512,8668463,592018,1961342,1232571,3530503,1824589,5491845
SP,201711,3729913,10375560,2889731,8755886,594930,1967825,1254932,3584633,1849862,5552458
SP,201712,3811135,10536889,2924328,8839373,597165,1971472,1276372,3634970,1873537,5606442
SP,201801,3868154,10656299,2962680,8936998,599207,1974637,1287536,3653932,1886743,5628569
SP,201802,3915457,10763877,2989908,9000954,601389,1977955,1303541,3687326,1904930,5665281
SP,201803,3785046,10360789,2864138,8596372,559033,1827764,1263482,3559656,1822515,5387420
SP,201804,3842336,10494540,2901604,8688101,563281,1836974,1285115,3608477,1848396,5445451
SP,201805,3917587,10670284,2951320,8810680,567798,1845412,1317029,3684228,1884827,5529640
SP,201806,3987741,10840102,2987124,8900600,571371,1852998,1331468,3713786,1902839,5566784
SP,201807,4051974,10995502,3019315,8978344,585314,1895889,1359317,3790804,1944631,5686693
SP,201808,3798089,10254680,2831067,8371148,554708,1791148,1340265,3732142,1894973,5523290
SP,201809,3877723,10442021,2875578,8484562,561130,1807533,1354955,3758237,1916085,5565770
SP,201810,3974829,10663000,2931774,8623658,559171,1795525,1362531,3746581,1921702,5542106
SP,201811,4035398,10787896,2961682,8690299,561647,1800474,1370816,3751110,1932463,5551584
SP,201812,3881379,10309786,2824081,8263861,520147,1666380,1326610,3627282,1846757,5293662
SP,201901,3946853,10458086,2878611,8417318,528907,1693663,1358276,3721984,1887183,5415647
SP,201902,4010835,10612687,2916049,8512819,532264,1701772,1379023,3768917,1911287,5470689
SP,201903,4064962,10743805,2949459,8596715,535537,1709770,1395056,3801732,1930593,5511502
SP,201904,4002058,10580767,2889807,8432756,515450,1645783,1371516,3745019,1886966,5390802
SP,201905,4063445,10725128,2928967,8530771,519204,1654899,1393291,3792940,1912495,5447839
SP,201906,4128169,10875470,2970337,8634264,523500,1665759,1416718,3845132,1940218,5510891
SP,201907,4176175,10979100,2998809,8701542,527128,1674546,1430500,3871883,1957628,5546429
SP,201908,4250722,11142549,3037159,8794397,530966,1682824,1446818,3901622,1977784,5584446
SP,201909,4024633,10433128,2851791,8189645,489747,1545567,1402153,3765124,1891900,5310691
SP,201910,4100624,10612569,2894018,8300043,495047,1559289,1422254,3810623,1917301,5369912
SP,201911,4153633,10736589,2925023,8379788,498090,1566923,1439461,3850161,1937551,5417084
SP,201912,4206308,10859041,2954061,8455169,500693,1573612,1455623,3888015,1956316,5461627
SP,202001,4240082,10936105,3023478,8630774,502042,1577027,1465554,3911012,1967596,5488039
SP,202002,4055016,10422628,2902829,8279493,480893,1509289,1448024,3867174,1928917,5376463
SP,202003,4113649,10564782,2942007,8368305,484092,1517711,1464152,3905350,1948244,5423061
SP,202004,4138816,10623553,2959814,8411836,485911,1522124,1474701,3928590,1960612,5450714
SP,202005,4173780,10704684,2989795,8484543,489011,1529577,1494179,3972975,1983190,5502552
SP,202006,4214318,10797057,3024097,8565741,492300,1536941,1516121,4021645,2008421,5558586
SP,202007,4257810,10890430,3059414,8645268,494970,1541692,1540493,4074746,2035463,5616438
SP,202008,4309737,11005936,3100687,8740113,498141,1548313,1568199,4134901,2066340,5683214
SP,202009,4347624,11087035,3129826,8804539,500649,1552653,1586595,4172378,2087244,5725031
SP,202010,4392003,11179288,3162036,8874094,502859,1555818,1607035,4213277,2109894,5769095
SP,202011,4169084,10594277,3018169,8458461,473062,1463857,1565313,4107984,2038375,5571841
SP,202012,4209597,10685553,3046577,8524275,475924,1470263,1582035,4142920,2057959,5613183
TO,201401,277131,885371,241242,826635,61455,227915,118832,411951,180287,639866
TO,201402,279037,888596,242163,828026,61351,227079,118792,410783,180143,637862
TO,201403,281620,893009,243322,829817,61124,225620,118487,408370,179611,633990
TO,201404,284085,897566,244446,831816,61095,224788,118209,406605,179304,631393
TO,201405,286507,901725,245532,833566,60565,220691,125826,432545,186391,653236
TO,201406,289091,906307,246563,835153,60646,220534,125623,430905,186269,651439
TO,201407,290466,908014,246866,834885,60416,219435,125250,428929,185666,648364
TO,201408,292931,912853,247915,837110,60614,219968,125064,427465,185678,647433
TO,201409,295032,916418,248719,838194,60733,220122,124846,425755,185579,645877
TO,201410,296723,920408,249420,840280,60893,220770,124686,424920,185579,645690
TO,201411,298280,923450,250076,841620,60991,220974,124674,424453,185665,645427
TO,201412,299601,925712,250446,842173,60937,220776,124502,423456,185439,644232
TO,201501,278268,864323,234403,791033,53258,195519,117304,400509,170562,596028
TO,201502,280839,869022,235457,793069,53380,195482,116881,398538,170261,594020
TO,201503,282853,873108,236343,795134,53657,196016,116125,395636,169782,591652
TO,201504,284046,875313,236788,795912,53711,195988,115783,393922,169494,589910
TO,201505,285782,878422,237485,797094,53617,195217,115376,391891,168993,587108
TO,201506,287396,880945,237909,797306,53539,194612,114078,386465,167617,581077
TO,201507,276887,850227,228738,767760,50738,184204,109636,371867,160374,556071
TO,201508,278875,853937,229496,769259,50886,184417,108815,368351,159701,552768
TO,201509,281055,857813,230416,770873,51122,184739,108116,365278,159238,550017
TO,201510,282903,861093,231322,772535,51303,184866,107681,363262,158984,548128
TO,201511,284660,864311,232154,774200,51512,185071,107446,362222,158958,547293
TO,201512,286788,868390,232854,775494,51694,185333,107157,360924,158851,546257
TO,201601,271586,834898,224509,756543,49286,178217,100081,346132,149367,524349
TO,201602,273293,838381,225444,758645,49286,178108,100664,347561,149950,525669
TO,201603,275497,842718,226634,761232,49368,178030,101248,348871,150616,526901
TO,201604,278043,847674,228097,764315,49456,177903,101816,349754,151272,527657
TO,201605,279723,850899,229052,766250,49552,178066,102210,350324,151762,528390
TO,201606,281443,853652,229752,767041,51542,186095,107348,368709,158890,554804
TO,201607,283100,856540,230462,768215,51586,185815,107136,367206,158722,553021
TO,201608,284730,859524,231142,769353,49962,178339,101583,345637,151545,523976
TO,201609,286190,862096,223456,750069,50036,178223,101465,344614,151501,522837
TO,201610,288002,864960,223483,749205,49845,177172,100905,341646,150750,518818
TO,201611,289472,867607,223539,748973,49873,176867,100595,340121,150468,516988
TO,201612,276378,834912,212638,718436,47364,168571,96128,327851,143492,496422
TO,201701,277925,838617,225641,750977,48236,172842,102196,350054,150432,522896
TO,201702,279920,842771,226818,753792,48218,172234,102932,352473,151150,524707
TO,201703,281640,845394,227640,754947,48159,171523,103445,353490,151604,525013
TO,201704,284471,849765,229194,757128,48078,170296,103922,353650,152000,523946
TO,201705,287593,855515,230839,760293,48235,170056,104065,353167,152300,523223
TO,201706,290139,860084,232136,762600,48627,170954,103270,349076,151897,520030
TO,201707,292316,864052,233066,764353,48774,171051,103091,347939,151865,518990
TO,201708,294622,868127,234020,766011,48880,171051,103133,347293,152013,518344
TO,201709,270061,802222,214781,709163,44369,155913,97887,333508,142256,489421
TO,201710,274012,810450,216562,713603,44468,156079,98480,334742,142948,490821
TO,201711,277684,817810,218008,717078,44362,155518,99168,336476,143530,491994
TO,201712,282260,827285,219632,721470,44083,154327,99825,338173,143908,492500
TO,201801,285794,834895,221491,726536,43961,153884,99912,337753,143873,491637
TO,201802,288720,840719,222993,729715,43887,153353,100409,338341,144296,491694
TO,201803,280448,818514,216017,708848,41583,145428,98091,331338,139674,476766
TO,201804,283649,824957,217766,712633,41721,145468,98606,331879,140327,477347
TO,201805,288152,834575,220388,718981,41751,145006,99930,335462,141681,480468
TO,201806,291903,841998,222537,723786,41857,144920,100371,335871,142228,480791
TO,201807,294236,846100,223785,725967,42814,148056,101831,340104,144645,488160
TO,201808,279350,806348,213411,693870,40830,141330,100001,334944,140831,476274
TO,201809,282971,813404,215565,698334,41127,141727,100316,334546,141443,476273
TO,201810,286800,821327,217787,703420,40760,139720,99477,330331,140237,470051
TO,201811,289112,824333,218774,704200,40833,139745,99231,327615,140064,467360
TO,201812,282339,804699,212935,685868,39230,134283,97029,320578,136259,454861
TO,201901,285406,811239,215810,693560,39538,135392,99062,327357,138600,462749
TO,201902,288320,817542,217538,697595,39559,135188,99964,329548,139523,464736
TO,201903,290800,822447,218957,700566,39586,134976,100280,329649,139866,464625
TO,201904,287009,812757,216058,691679,38689,131957,99007,325718,137696,457675
TO,201905,289974,818944,217912,696012,39016,132846,99504,326587,138520,459433
TO,201906,292882,825162,219574,700132,39182,133093,100180,328142,139362,461235
TO,201907,294802,827916,220532,701424,39290,133179,100295,327449,139585,460628
TO,201908,297332,832478,221564,703268,39381,133319,100327,326637,139708,459956
TO,201909,284322,794488,211628,671656,37343,126752,98352,320727,135695,447479
TO,201910,288145,803009,213878,677352,37546,127137,98907,321856,136453,448993
TO,201911,291014,809163,215409,681117,37697,127323,99354,322831,137051,450154
TO,201912,293814,815397,216909,685030,37883,127758,99778,323759,137661,451517
TO,202001,295468,819146,220537,693390,37913,127760,100065,324506,137978,452266
TO,202002,284961,792816,213487,674302,36763,123845,99204,322900,135967,446745
TO,202003,287781,798918,215612,678347,36899,123994,99771,324240,136670,448234
TO,202004,288881,800627,216430,679611,36995,123927,100303,325221,137298,449148
TO,202005,291064,804084,218368,682777,37209,124043,101273,326589,138482,450632
TO,202006,292146,805795,219282,684226,37335,124190,101615,326884,138950,451074
TO,202007,293384,807788,220330,685942,37510,124475,101946,327165,139456,451640
TO,202008,294688,809887,221329,687550,37729,124861,102073,326902,139802,451763
TO,202009,295947,811594,222290,688780,37989,125374,102281,326462,140270,451836
TO,202010,297694,814293,223560,690805,38181,125509,102701,326857,140882,452366
TO,202011,286446,787463,216962,672111,36883,121440,101230,323115,138113,444555
TO,202012,288213,790654,218273,674616,37099,121774,101684,323847,138783,445621
